Age,Date,Tm,Home,Opp,Win,GS,MP,FG,FGA,FG%,2P,2PA,2P%,3P,3PA,3P%,FT,FTA,FT%,ORB,DRB,TRB,AST,STL,BLK,TOV,PF,PTS,GmSc
18-303,2003-10-29,CLE,A,SAC,L,1,43,12,20,.600,12,18,.667,0,2,.000,1,3,.333,2,4,6,9,4,0,2,3,25,24.7
18-304,2003-10-30,CLE,A,PHO,L,1,40,8,17,.471,7,12,.583,1,5,.200,4,7,.571,2,10,12,8,1,0,7,1,21,14.7
18-306,2003-11-01,CLE,A,POR,L,1,39,3,12,.250,3,11,.273,0,1,.000,2,2,1.000,0,4,4,6,2,0,2,3,8,5.0
18-310,2003-11-05,CLE,H,DEN,L,1,41,3,11,.273,3,9,.333,0,2,.000,1,1,1.000,2,9,11,7,2,3,2,1,7,11.2
18-312,2003-11-07,CLE,A,IND,L,1,44,8,18,.444,7,16,.438,1,2,.500,6,7,.857,0,5,5,3,0,0,7,2,23,9.0
18-313,2003-11-08,CLE,H,WAS,W,1,45,8,19,.421,8,19,.421,0,0,,1,4,.250,5,3,8,9,1,1,2,1,17,15.7
18-315,2003-11-10,CLE,H,NYK,W,1,34,7,12,.583,4,9,.444,3,3,1.000,0,0,,1,4,5,4,1,1,2,0,17,15.8
18-317,2003-11-12,CLE,A,MIA,L,1,43,6,15,.400,4,10,.400,2,5,.400,4,6,.667,1,2,3,7,2,1,4,3,18,12.8
18-319,2003-11-14,CLE,A,BOS,L,1,36,3,12,.250,1,8,.125,2,4,.500,2,4,.500,1,4,5,3,0,0,4,3,10,0.8
18-320,2003-11-15,CLE,H,PHI,W,1,47,10,19,.526,10,18,.556,0,1,.000,2,4,.500,0,5,5,8,1,2,5,2,22,15.6
18-323,2003-11-18,CLE,H,LAC,W,1,39,6,16,.375,6,14,.429,0,2,.000,2,4,.500,2,5,7,8,0,1,3,2,14,9.8
18-324,2003-11-19,CLE,A,WAS,L,1,39,10,18,.556,8,14,.571,2,4,.500,6,8,.750,2,5,7,8,2,1,4,2,28,25.0
18-326,2003-11-21,CLE,H,MIN,L,1,35,8,19,.421,8,17,.471,0,2,.000,3,3,1.000,2,7,9,2,1,0,1,4,19,12.2
18-327,2003-11-22,CLE,A,ATL,L,1,42,3,16,.188,3,15,.200,0,1,.000,9,10,.900,2,4,6,4,2,1,3,1,15,9.3
18-331,2003-11-26,CLE,A,NOH,L,1,39,5,17,.294,4,13,.308,1,4,.250,4,4,1.000,2,6,8,9,0,0,4,1,15,10.2
18-333,2003-11-28,CLE,A,DET,L,1,36,2,8,.250,2,6,.333,0,2,.000,2,3,.667,0,2,2,7,0,0,4,3,6,1.1
18-334,2003-11-29,CLE,H,MEM,L,1,55,14,28,.500,11,22,.500,3,6,.500,2,3,.667,2,14,16,7,1,1,8,1,33,22.4
18-337,2003-12-02,CLE,A,DEN,L,1,33,6,19,.316,4,16,.250,2,3,.667,5,7,.714,3,3,6,5,2,0,2,4,19,12.2
18-338,2003-12-03,CLE,A,LAC,L,1,34,2,13,.154,2,10,.200,0,3,.000,0,0,,4,2,6,8,2,0,5,2,4,0.9
18-341,2003-12-06,CLE,H,ATL,W,1,36,4,12,.333,4,10,.400,0,2,.000,0,0,,1,5,6,5,2,1,3,2,8,5.8
18-344,2003-12-09,CLE,H,TOR,L,1,37,7,16,.438,7,16,.438,0,0,,4,4,1.000,0,5,5,3,1,0,2,2,18,11.4
18-346,2003-12-11,CLE,H,DET,W,1,43,8,21,.381,7,18,.389,1,3,.333,6,8,.750,1,2,3,9,1,1,4,3,23,14.8
18-348,2003-12-13,CLE,H,BOS,L,1,45,10,20,.500,9,15,.600,1,5,.200,16,18,.889,1,2,3,4,0,0,2,2,37,27.5
18-350,2003-12-15,CLE,A,IND,L,1,44,10,16,.625,10,13,.769,0,3,.000,7,8,.875,1,3,4,6,3,3,6,1,27,23.9
18-352,2003-12-17,CLE,H,HOU,L,1,36,7,19,.368,5,15,.333,2,4,.500,1,2,.500,0,1,1,3,0,0,2,2,17,5.7
18-354,2003-12-19,CLE,A,PHI,W,1,42,14,24,.583,9,17,.529,5,7,.714,3,3,1.000,1,3,4,5,4,0,4,1,36,29.5
18-355,2003-12-20,CLE,A,CHI,W,1,42,11,22,.500,11,17,.647,0,5,.000,10,12,.833,1,5,6,10,2,2,4,2,32,28.0
18-358,2003-12-23,CLE,H,NOH,W,1,39,7,22,.318,6,16,.375,1,6,.167,7,8,.875,2,4,6,2,6,1,5,1,22,14.3
18-360,2003-12-25,CLE,A,ORL,L,1,47,13,28,.464,9,18,.500,4,10,.400,4,5,.800,1,1,2,6,2,1,8,0,34,19.1
18-361,2003-12-26,CLE,H,CHI,L,1,34,7,24,.292,6,20,.300,1,4,.250,3,4,.750,1,2,3,4,1,2,5,0,18,5.1
18-363,2003-12-28,CLE,H,POR,W,1,39,15,23,.652,15,21,.714,0,2,.000,2,2,1.000,3,7,10,9,3,0,5,1,32,30.0
19-000,2003-12-30,CLE,H,IND,L,1,38,9,20,.450,9,16,.563,0,4,.000,4,6,.667,2,8,10,4,0,0,4,2,22,12.6
19-003,2004-01-02,CLE,A,NJN,L,1,36,6,19,.316,6,15,.400,0,4,.000,2,4,.500,1,3,4,9,1,0,3,2,14,7.4
19-007,2004-01-06,CLE,H,NYK,W,1,41,6,17,.353,6,15,.400,0,2,.000,2,2,1.000,0,4,4,10,1,1,4,1,14,10.0
19-008,2004-01-07,CLE,A,TOR,L,1,38,10,23,.435,10,20,.500,0,3,.000,1,2,.500,0,2,2,5,0,0,2,3,21,9.4
19-010,2004-01-09,CLE,A,BOS,L,1,42,7,19,.368,7,16,.438,0,3,.000,5,7,.714,0,3,3,6,3,0,5,1,19,10.4
19-013,2004-01-12,CLE,A,LAL,L,1,36,6,20,.300,6,17,.353,0,3,.000,4,5,.800,1,4,5,7,1,1,6,3,16,5.3
19-014,2004-01-13,CLE,A,SEA,W,1,44,11,26,.423,11,25,.440,0,1,.000,5,6,.833,4,5,9,9,2,0,4,2,27,20.6
19-016,2004-01-15,CLE,A,GSW,L,1,43,8,21,.381,6,16,.375,2,5,.400,11,13,.846,2,4,6,6,3,0,2,0,29,24.5
19-018,2004-01-17,CLE,A,UTA,W,1,44,12,28,.429,10,24,.417,2,4,.500,3,5,.600,1,6,7,2,2,1,4,2,29,15.2
19-027,2004-01-26,CLE,H,ORL,W,1,30,7,19,.368,6,17,.353,1,2,.500,1,2,.500,0,5,5,3,0,2,3,4,16,5.5
19-029,2004-01-28,CLE,H,MIA,W,1,44,10,25,.400,10,24,.417,0,1,.000,7,10,.700,0,5,5,4,2,1,1,1,27,17.9
19-031,2004-01-30,CLE,A,MIL,L,1,37,7,25,.280,6,19,.316,1,6,.167,5,8,.625,2,6,8,3,1,0,5,5,20,3.4
19-033,2004-02-01,CLE,A,WAS,W,1,43,14,27,.519,13,25,.520,1,2,.500,9,11,.818,3,3,6,4,0,2,6,4,38,23.5
19-035,2004-02-03,CLE,A,DET,W,1,38,5,19,.263,5,18,.278,0,1,.000,2,2,1.000,1,3,4,6,2,0,1,2,12,6.7
19-036,2004-02-04,CLE,H,LAL,L,1,43,12,26,.462,8,22,.364,4,4,1.000,4,5,.800,0,4,4,4,0,0,0,0,32,22.2
19-038,2004-02-06,CLE,A,MIN,L,1,45,6,18,.333,5,15,.333,1,3,.333,1,4,.250,1,8,9,5,0,0,3,2,14,5.4
19-039,2004-02-07,CLE,H,WAS,L,1,34,6,16,.375,6,16,.375,0,0,,2,2,1.000,0,0,0,6,4,1,3,2,14,10.3
19-041,2004-02-09,CLE,H,BOS,W,1,43,9,25,.360,8,19,.421,1,6,.167,5,6,.833,0,6,6,3,2,1,1,3,24,14.1
19-043,2004-02-11,CLE,H,NJN,L,1,30,2,13,.154,2,12,.167,0,1,.000,5,5,1.000,1,1,2,5,1,0,5,0,9,1.2
19-050,2004-02-18,CLE,H,DAL,L,1,34,6,12,.500,6,12,.500,0,0,,4,4,1.000,2,2,4,9,0,1,5,2,16,13.2
19-052,2004-02-20,CLE,H,SAS,W,1,40,14,23,.609,14,23,.609,0,0,,4,4,1.000,2,9,11,2,2,1,2,0,32,27.7
19-054,2004-02-22,CLE,A,NYK,W,1,44,7,20,.350,7,20,.350,0,0,,8,12,.667,1,4,5,3,1,0,1,2,22,12.4
19-055,2004-02-23,CLE,H,NOH,W,1,37,7,16,.438,6,11,.545,1,5,.200,6,6,1.000,0,4,4,6,2,5,1,3,21,21.3
19-057,2004-02-25,CLE,A,HOU,L,1,39,5,18,.278,5,16,.313,0,2,.000,1,3,.333,2,5,7,5,2,1,2,1,11,6.3
19-059,2004-02-27,CLE,A,ORL,W,1,49,11,19,.579,10,18,.556,1,1,1.000,7,8,.875,1,10,11,3,3,1,5,1,30,24.8
19-062,2004-03-01,CLE,A,CHI,L,1,41,7,17,.412,7,15,.467,0,2,.000,4,6,.667,0,3,3,3,4,1,3,2,18,12.0
19-064,2004-03-03,CLE,H,ATL,W,1,28,9,17,.529,8,15,.533,1,2,.500,5,6,.833,1,6,7,3,1,1,1,0,24,20.6
19-066,2004-03-05,CLE,A,NOH,W,1,38,7,17,.412,5,15,.333,2,2,1.000,3,4,.750,2,4,6,4,2,0,4,5,19,10.9
19-067,2004-03-06,CLE,H,MIL,W,1,43,11,24,.458,11,21,.524,0,3,.000,2,3,.667,2,5,7,10,4,1,2,3,24,22.6
19-069,2004-03-08,CLE,A,ATL,W,1,45,11,23,.478,10,19,.526,1,4,.250,11,13,.846,2,4,6,7,1,0,2,1,34,27.6
19-071,2004-03-10,CLE,A,TOR,W,1,34,4,13,.308,4,13,.308,0,0,,6,7,.857,1,2,3,4,1,0,2,2,14,8.4
19-075,2004-03-14,CLE,H,IND,W,1,44,12,22,.545,12,20,.600,0,2,.000,2,4,.500,0,3,3,4,3,1,4,3,26,16.8
19-077,2004-03-16,CLE,H,CHI,W,1,32,5,16,.313,3,13,.231,2,3,.667,5,8,.625,3,2,5,8,0,5,4,1,17,14.0
19-080,2004-03-19,CLE,H,UTA,L,1,34,4,14,.286,4,12,.333,0,2,.000,6,10,.600,0,0,0,7,2,1,2,3,14,8.6
19-082,2004-03-21,CLE,H,DET,L,1,37,5,17,.294,4,13,.308,1,4,.250,4,5,.800,2,5,7,3,0,2,4,4,15,5.5
19-084,2004-03-23,CLE,H,PHO,L,1,41,8,21,.381,6,16,.375,2,5,.400,7,9,.778,1,1,2,6,3,1,5,0,25,16.6
19-087,2004-03-26,CLE,A,PHI,L,1,33,5,13,.385,4,11,.364,1,2,.500,5,9,.556,2,1,3,7,0,1,5,1,16,9.2
19-088,2004-03-27,CLE,H,NJN,W,1,44,15,29,.517,14,27,.519,1,2,.500,10,10,1.000,2,4,6,13,3,0,2,1,41,39.0
19-090,2004-03-29,CLE,A,SAS,L,1,32,9,20,.450,9,19,.474,0,1,.000,0,0,,0,2,2,4,0,1,2,0,18,9.7
19-091,2004-03-30,CLE,A,DAL,L,1,42,13,22,.591,13,20,.650,0,2,.000,2,4,.500,1,4,5,6,4,0,3,2,28,23.3
19-094,2004-04-02,CLE,A,MIL,L,1,37,9,19,.474,9,19,.474,0,0,,2,2,1.000,0,7,7,7,5,0,5,3,20,16.1
19-095,2004-04-03,CLE,H,GSW,L,1,46,12,28,.429,9,23,.391,3,5,.600,7,11,.636,3,5,8,10,1,1,3,1,34,26.5
19-098,2004-04-06,CLE,H,TOR,L,1,46,5,17,.294,5,17,.294,0,0,,11,14,.786,1,5,6,4,3,0,3,2,21,14.1
19-099,2004-04-07,CLE,A,MEM,L,1,37,4,11,.364,4,11,.364,0,0,,6,7,.857,0,3,3,5,3,0,2,4,14,11.3
19-101,2004-04-09,CLE,A,MIA,L,1,42,6,14,.429,5,13,.385,1,1,1.000,11,15,.733,1,6,7,8,1,0,8,2,24,15.3
19-102,2004-04-10,CLE,H,MIA,W,1,32,4,11,.364,4,9,.444,0,2,.000,2,5,.400,1,2,3,11,0,0,2,3,10,8.5
19-104,2004-04-12,CLE,H,MIL,W,1,45,9,20,.450,8,16,.500,1,4,.250,8,11,.727,1,6,7,9,2,0,1,1,27,24.8
19-106,2004-04-14,CLE,A,NYK,W,1,35,8,17,.471,8,14,.571,0,3,.000,1,1,1.000,0,1,1,5,3,0,5,1,17,9.7
19-309,2004-11-03,CLE,H,IND,L,1,51,8,19,.421,6,14,.429,2,5,.400,10,12,.833,1,4,5,8,1,3,6,2,28,20.9
19-310,2004-11-04,CLE,A,MIA,L,1,42,9,22,.409,7,19,.368,2,3,.667,1,1,1.000,3,3,6,8,1,0,1,0,21,17.8
19-312,2004-11-06,CLE,A,MIL,L,1,42,8,20,.400,8,17,.471,0,3,.000,15,22,.682,2,6,8,6,3,0,4,0,31,23.8
19-315,2004-11-09,CLE,A,ATL,W,1,48,8,17,.471,7,13,.538,1,4,.250,8,12,.667,1,9,10,4,4,2,3,2,25,22.5
19-316,2004-11-10,CLE,H,PHO,W,1,48,13,24,.542,12,22,.545,1,2,.500,11,12,.917,3,7,10,6,3,3,3,1,38,36.1
19-319,2004-11-13,CLE,H,WAS,W,1,37,10,20,.500,10,17,.588,0,3,.000,4,5,.800,1,8,9,4,3,2,4,0,24,19.9
19-321,2004-11-15,CLE,H,GSW,W,1,42,12,22,.545,9,17,.529,3,5,.600,6,8,.750,2,10,12,4,2,1,1,1,33,30.1
19-324,2004-11-18,CLE,A,CHA,W,1,29,8,14,.571,6,11,.545,2,3,.667,1,2,.500,1,5,6,9,0,0,1,3,19,18.3
19-326,2004-11-20,CLE,H,CHA,W,1,38,11,20,.550,11,18,.611,0,2,.000,3,4,.750,5,3,8,2,3,1,7,0,25,17.5
19-327,2004-11-21,CLE,A,NYK,L,1,41,5,15,.333,4,12,.333,1,3,.333,2,3,.667,2,7,9,10,1,1,5,3,13,10.1
19-330,2004-11-24,CLE,H,DET,W,1,38,15,22,.682,13,19,.684,2,3,.667,11,12,.917,3,3,6,5,3,1,3,3,43,39.2
19-332,2004-11-26,CLE,A,BOS,W,1,43,9,13,.692,9,11,.818,0,2,.000,2,3,.667,0,6,6,8,3,1,2,2,20,22.4
19-333,2004-11-27,CLE,H,CHI,W,1,32,11,17,.647,10,15,.667,1,2,.500,3,4,.750,1,6,7,7,1,0,2,0,26,24.5
19-335,2004-11-29,CLE,A,LAC,L,1,42,9,19,.474,9,17,.529,0,2,.000,4,5,.800,1,6,7,5,6,1,3,2,22,20.8
19-337,2004-12-01,CLE,A,PHO,L,1,41,6,19,.316,6,17,.353,0,2,.000,3,4,.750,1,2,3,6,2,1,6,2,15,5.1
19-338,2004-12-02,CLE,A,DEN,W,1,41,8,17,.471,8,17,.471,0,0,,1,2,.500,1,7,8,9,2,1,5,3,17,13.5
19-340,2004-12-04,CLE,H,TOR,W,1,43,10,17,.588,9,14,.643,1,3,.333,6,7,.857,0,6,6,10,2,1,3,2,27,26.4
19-343,2004-12-07,CLE,H,NJN,W,1,46,11,22,.500,11,21,.524,0,1,.000,5,6,.833,0,2,2,8,3,0,3,4,27,20.2
19-351,2004-12-15,CLE,H,POR,W,1,37,10,18,.556,8,15,.533,2,3,.667,3,3,1.000,2,9,11,7,3,2,3,1,25,26.4
19-352,2004-12-16,CLE,A,DET,L,1,45,4,21,.190,4,19,.211,0,2,.000,3,5,.600,1,8,9,7,4,1,3,2,11,6.0
19-354,2004-12-18,CLE,H,BOS,L,1,41,12,25,.480,9,20,.450,3,5,.600,4,8,.500,1,4,5,4,3,1,4,6,31,18.7
19-357,2004-12-21,CLE,H,MIN,W,1,43,10,18,.556,10,17,.588,0,1,.000,6,8,.750,0,6,6,12,1,0,2,2,26,25.0
19-358,2004-12-22,CLE,A,NJN,L,1,43,7,18,.389,6,17,.353,1,1,1.000,8,10,.800,1,8,9,9,1,0,4,2,23,18.0
19-362,2004-12-26,CLE,H,NOH,W,1,45,7,16,.438,7,15,.467,0,1,.000,8,9,.889,1,8,9,14,4,1,5,2,22,25.0
19-364,2004-12-28,CLE,A,ATL,W,1,46,13,25,.520,10,20,.500,3,5,.600,11,14,.786,1,8,9,7,1,0,1,2,40,33.7
19-365,2004-12-29,CLE,H,HOU,L,1,17,0,5,.000,0,4,.000,0,1,.000,3,5,.600,0,3,3,5,0,0,0,0,3,3.1
20-004,2005-01-03,CLE,A,CHA,W,1,40,11,19,.579,11,16,.688,0,3,.000,4,6,.667,2,6,8,6,2,0,1,3,26,23.5
20-006,2005-01-05,CLE,H,ATL,W,1,40,7,14,.500,5,9,.556,2,5,.400,4,6,.667,1,5,6,9,1,1,2,4,20,18.8
20-009,2005-01-08,CLE,H,NYK,W,1,33,10,14,.714,10,14,.714,0,0,,2,2,1.000,1,2,3,4,0,2,8,2,22,12.9
20-012,2005-01-11,CLE,H,CHA,W,1,49,11,24,.458,9,19,.474,2,5,.400,5,7,.714,1,7,8,9,2,1,8,1,29,19.2
20-014,2005-01-13,CLE,A,LAL,L,1,44,12,26,.462,11,22,.500,1,4,.250,3,4,.750,3,10,13,9,1,1,4,1,28,22.9
20-016,2005-01-15,CLE,A,UTA,W,1,41,9,20,.450,9,19,.474,0,1,.000,9,14,.643,1,7,8,5,5,0,3,2,27,22.1
20-017,2005-01-16,CLE,A,SEA,L,1,44,14,30,.467,11,23,.478,3,7,.429,4,6,.667,2,3,5,11,4,1,1,4,35,30.9
20-020,2005-01-19,CLE,A,POR,W,1,44,11,16,.688,10,15,.667,1,1,1.000,4,6,.667,1,10,11,10,4,0,2,4,27,30.5
20-021,2005-01-20,CLE,A,SAC,L,1,37,9,19,.474,9,18,.500,0,1,.000,0,1,.000,1,7,8,6,1,0,3,0,18,12.9
20-023,2005-01-22,CLE,A,GSW,W,1,43,13,24,.542,13,23,.565,0,1,.000,2,2,1.000,1,11,12,10,1,1,3,1,28,25.7
20-025,2005-01-24,CLE,H,WAS,L,1,48,12,26,.462,11,25,.440,1,1,1.000,6,10,.600,4,6,10,8,2,1,5,3,31,22.7
20-027,2005-01-26,CLE,H,MEM,W,1,42,10,16,.625,6,10,.600,4,6,.667,3,4,.750,1,8,9,15,3,2,5,1,27,32.0
20-033,2005-02-01,CLE,A,ORL,L,1,43,10,20,.500,10,17,.588,0,3,.000,8,13,.615,2,3,5,7,0,1,3,2,28,20.1
20-035,2005-02-03,CLE,A,MIA,L,1,46,11,23,.478,10,20,.500,1,3,.333,8,12,.667,2,0,2,10,3,0,2,2,31,26.3
20-037,2005-02-05,CLE,H,ORL,W,1,46,9,21,.429,9,18,.500,0,3,.000,12,13,.923,0,6,6,9,2,0,1,2,30,26.8
20-040,2005-02-08,CLE,H,TOR,W,1,36,6,14,.429,6,11,.545,0,3,.000,3,4,.750,1,7,8,11,3,0,2,1,15,18.3
20-043,2005-02-11,CLE,H,DEN,L,1,43,12,29,.414,11,23,.478,1,6,.167,10,12,.833,2,4,6,6,1,0,4,2,35,21.7
20-045,2005-02-13,CLE,H,LAL,W,1,46,8,20,.400,8,20,.400,0,0,,9,10,.900,2,6,8,9,3,1,3,3,25,22.8
20-048,2005-02-16,CLE,H,ATL,W,1,37,11,20,.550,9,18,.500,2,2,1.000,4,5,.800,0,5,5,6,3,0,3,0,28,23.7
20-049,2005-02-17,CLE,A,MIN,L,1,41,10,19,.526,9,17,.529,1,2,.500,5,6,.833,2,5,7,8,1,0,2,0,26,23.8
20-055,2005-02-23,CLE,H,CHI,W,1,44,8,17,.471,7,16,.438,1,1,1.000,10,15,.667,1,5,6,11,5,0,3,2,27,27.4
20-057,2005-02-25,CLE,A,IND,L,1,40,9,25,.360,9,24,.375,0,1,.000,3,4,.750,3,4,7,5,2,1,2,0,21,14.2
20-059,2005-02-27,CLE,A,NJN,L,1,45,9,20,.450,8,18,.444,1,2,.500,9,10,.900,1,3,4,7,2,0,5,4,28,19.1
20-060,2005-02-28,CLE,H,SAS,L,1,45,6,22,.273,5,18,.278,1,4,.250,7,10,.700,1,7,8,7,0,0,2,3,20,10.3
20-062,2005-03-02,CLE,H,SEA,L,1,41,11,20,.550,6,13,.462,5,7,.714,5,8,.625,0,5,5,5,0,0,4,2,32,21.4
20-064,2005-03-04,CLE,A,PHI,L,1,40,12,21,.571,12,20,.600,0,1,.000,10,12,.833,1,6,7,7,4,0,6,1,34,28.3
20-066,2005-03-06,CLE,H,MIA,L,1,40,9,19,.474,9,18,.500,0,1,.000,5,7,.714,0,4,4,5,2,0,1,1,23,17.8
20-068,2005-03-08,CLE,H,ORL,W,1,41,9,22,.409,7,16,.438,2,6,.333,3,4,.750,0,7,7,8,1,1,1,3,23,18.0
20-073,2005-03-13,CLE,H,IND,W,1,43,12,23,.522,11,18,.611,1,5,.200,10,11,.909,2,3,5,5,1,0,4,1,35,25.7
20-075,2005-03-15,CLE,H,UTA,W,1,34,11,15,.733,9,10,.900,2,5,.400,12,16,.750,2,7,9,2,0,1,1,1,36,32.5
20-076,2005-03-16,CLE,A,MIL,L,1,45,13,26,.500,9,17,.529,4,9,.444,4,7,.571,1,6,7,6,1,0,5,0,34,22.5
20-078,2005-03-18,CLE,H,PHI,L,1,46,3,20,.150,3,16,.188,0,4,.000,10,12,.833,0,8,8,8,4,0,4,0,16,10.4
20-080,2005-03-20,CLE,A,TOR,L,1,48,18,36,.500,12,24,.500,6,12,.500,14,15,.933,2,8,10,5,2,0,4,0,56,42.9
20-082,2005-03-22,CLE,H,DET,W,1,43,11,24,.458,9,17,.529,2,7,.286,5,8,.625,1,5,6,6,1,0,0,1,29,22.4
20-084,2005-03-24,CLE,A,HOU,L,1,42,7,22,.318,6,18,.333,1,4,.250,4,7,.571,0,4,4,8,1,0,2,1,19,10.6
20-086,2005-03-26,CLE,A,DAL,L,1,36,7,17,.412,7,15,.467,0,2,.000,5,6,.833,1,3,4,6,0,0,3,1,19,11.9
20-088,2005-03-28,CLE,A,NOH,W,1,53,16,29,.552,13,19,.684,3,10,.300,9,11,.818,2,4,6,3,4,0,10,3,44,26.8
20-089,2005-03-29,CLE,H,LAC,W,1,41,7,20,.350,5,12,.417,2,8,.250,6,7,.857,0,7,7,5,2,1,1,0,22,17.7
20-091,2005-03-31,CLE,A,CHI,L,1,53,10,28,.357,9,24,.375,1,4,.250,5,11,.455,4,2,6,7,4,2,3,5,26,16.7
20-092,2005-04-01,CLE,H,SAC,L,1,44,13,21,.619,11,17,.647,2,4,.500,7,10,.700,0,8,8,9,2,0,7,2,35,27.2
20-094,2005-04-03,CLE,H,DAL,W,1,48,10,23,.435,6,15,.400,4,8,.500,13,13,1.000,2,8,10,7,2,1,6,3,37,29.1
20-096,2005-04-05,CLE,H,NJN,L,1,40,9,19,.474,6,13,.462,3,6,.500,3,6,.500,2,7,9,4,2,2,6,2,24,16.0
20-097,2005-04-06,CLE,A,IND,L,1,33,9,18,.500,9,15,.600,0,3,.000,2,4,.500,2,2,4,3,1,0,2,2,20,12.5
20-099,2005-04-08,CLE,A,PHI,L,1,48,12,30,.400,10,24,.417,2,6,.333,11,11,1.000,4,9,13,7,5,0,5,1,37,30.8
20-100,2005-04-09,CLE,H,MIL,W,1,47,15,26,.577,8,13,.615,7,13,.538,3,3,1.000,1,9,10,10,2,1,3,2,40,37.1
20-102,2005-04-11,CLE,A,ORL,W,1,48,12,23,.522,11,17,.647,1,6,.167,8,10,.800,1,6,7,6,5,1,2,4,33,29.7
20-105,2005-04-14,CLE,H,NYK,L,1,42,7,25,.280,3,12,.250,4,13,.308,9,14,.643,1,17,18,7,2,2,4,3,27,19.2
20-106,2005-04-15,CLE,A,WAS,L,1,48,16,33,.485,15,27,.556,1,6,.167,5,8,.625,2,4,6,6,1,0,1,3,38,25.7
20-108,2005-04-17,CLE,A,DET,L,1,45,12,35,.343,10,28,.357,2,7,.286,11,14,.786,3,8,11,6,0,1,1,0,37,24.5
20-110,2005-04-19,CLE,H,BOS,W,1,46,13,27,.481,11,24,.458,2,3,.667,4,5,.800,1,7,8,6,5,0,3,3,32,25.7
20-111,2005-04-20,CLE,A,TOR,W,1,48,10,23,.435,8,15,.533,2,8,.250,5,10,.500,2,12,14,14,0,1,2,1,27,26.0
20-307,2005-11-02,CLE,H,NOK,W,1,33,9,16,.563,3,9,.333,6,7,.857,7,8,.875,1,2,3,4,2,0,3,3,31,24.9
20-309,2005-11-04,CLE,A,SAS,L,1,37,7,16,.438,7,13,.538,0,3,.000,6,7,.857,0,6,6,4,0,1,3,3,20,12.3
20-310,2005-11-05,CLE,A,MEM,L,1,41,14,29,.483,10,20,.500,4,9,.444,4,5,.800,0,2,2,6,2,0,2,2,36,24.9
20-312,2005-11-07,CLE,A,TOR,W,1,36,9,17,.529,9,15,.600,0,2,.000,9,12,.750,0,3,3,6,1,2,1,3,27,22.8
20-314,2005-11-09,CLE,H,SEA,W,1,36,10,18,.556,10,16,.625,0,2,.000,11,11,1.000,1,4,5,1,0,1,4,1,31,21.3
20-316,2005-11-11,CLE,H,MEM,W,1,26,5,11,.455,5,10,.500,0,1,.000,6,6,1.000,1,5,6,2,3,1,3,5,16,12.6
20-318,2005-11-13,CLE,A,ORL,W,1,49,9,20,.450,8,16,.500,1,4,.250,7,11,.636,0,5,5,3,0,1,2,2,26,15.5
20-320,2005-11-15,CLE,H,WAS,W,1,42,15,23,.652,13,20,.650,2,3,.667,5,5,1.000,1,9,10,4,0,2,3,1,37,31.1
20-323,2005-11-18,CLE,H,ORL,W,1,34,6,17,.353,6,14,.429,0,3,.000,4,6,.667,1,5,6,4,2,0,4,2,16,7.9
20-324,2005-11-19,CLE,A,PHI,W,1,47,14,24,.583,14,22,.636,0,2,.000,8,10,.800,2,9,11,10,1,1,5,1,36,31.4
20-327,2005-11-22,CLE,H,BOS,W,1,41,13,20,.650,12,17,.706,1,3,.333,9,11,.818,0,5,5,4,2,2,1,4,36,31.5
20-329,2005-11-24,CLE,A,IND,L,1,43,6,20,.300,6,16,.375,0,4,.000,7,11,.636,1,9,10,4,5,1,6,4,19,10.1
20-331,2005-11-26,CLE,H,MIN,L,1,44,13,29,.448,7,18,.389,6,11,.545,6,6,1.000,2,3,5,2,4,0,2,2,38,27.8
20-335,2005-11-30,CLE,H,LAC,W,1,50,7,20,.350,7,17,.412,0,3,.000,14,17,.824,0,7,7,9,1,1,6,1,28,19.3
20-337,2005-12-02,CLE,A,SEA,L,1,45,14,27,.519,14,22,.636,0,5,.000,6,8,.750,0,3,3,8,1,3,1,1,34,28.1
20-338,2005-12-03,CLE,A,LAC,L,1,45,8,25,.320,5,20,.250,3,5,.600,11,14,.786,0,5,5,6,1,1,1,3,30,19.7
20-341,2005-12-06,CLE,A,SAC,W,1,44,10,23,.435,9,18,.500,1,5,.200,9,12,.750,2,4,6,6,2,3,5,2,30,21.8
20-344,2005-12-09,CLE,H,NJN,L,1,45,11,26,.423,11,22,.500,0,4,.000,10,15,.667,2,4,6,3,0,1,7,3,32,13.4
20-345,2005-12-10,CLE,A,MIL,L,1,43,19,29,.655,14,20,.700,5,9,.556,9,10,.900,0,7,7,7,2,0,3,5,52,42.9
20-348,2005-12-13,CLE,H,ATL,L,1,45,13,23,.565,10,17,.588,3,6,.500,10,16,.625,0,10,10,6,2,0,6,5,39,26.9
20-350,2005-12-15,CLE,H,DEN,W,1,45,11,18,.611,10,14,.714,1,4,.250,3,6,.500,0,4,4,9,1,0,3,3,26,20.9
20-352,2005-12-17,CLE,H,MIA,W,1,46,12,19,.632,10,15,.667,2,4,.500,15,16,.938,0,5,5,10,1,0,4,3,41,36.4
20-355,2005-12-20,CLE,H,UTA,W,1,29,8,12,.667,7,11,.636,1,1,1.000,8,9,.889,2,4,6,4,3,2,5,1,25,23.8
20-357,2005-12-22,CLE,A,CHI,W,1,44,12,25,.480,8,19,.421,4,6,.667,9,13,.692,0,5,5,6,4,0,2,2,37,29.6
20-358,2005-12-23,CLE,H,IND,W,1,44,4,16,.250,4,15,.267,0,1,.000,6,11,.545,1,7,8,9,1,0,3,1,14,9.1
20-361,2005-12-26,CLE,H,CHI,W,1,45,12,25,.480,12,20,.600,0,5,.000,8,12,.667,1,7,8,6,2,2,2,0,32,26.1
20-362,2005-12-27,CLE,A,NJN,L,1,40,12,21,.571,11,16,.688,1,5,.200,6,9,.667,1,9,10,8,2,0,4,3,31,25.7
21-001,2005-12-31,CLE,H,DET,W,1,45,11,22,.500,9,17,.529,2,5,.400,6,7,.857,1,6,7,7,4,1,5,2,30,24.9
21-005,2006-01-04,CLE,A,MIL,W,1,46,12,29,.414,10,21,.476,2,8,.250,6,7,.857,2,9,11,11,5,1,4,1,32,29.2
21-006,2006-01-05,CLE,H,HOU,L,1,44,13,19,.684,10,12,.833,3,7,.429,3,6,.500,1,8,9,5,1,0,3,4,32,25.7
21-008,2006-01-07,CLE,H,MIL,W,1,45,14,22,.636,11,15,.733,3,7,.429,4,9,.444,2,5,7,6,0,1,0,1,35,30.6
21-011,2006-01-10,CLE,H,NYK,L,1,46,14,31,.452,14,24,.583,0,7,.000,8,11,.727,0,7,7,7,0,1,1,0,36,25.4
21-013,2006-01-12,CLE,A,LAL,L,1,40,11,22,.500,9,19,.474,2,3,.667,4,9,.444,0,2,2,9,0,0,5,2,28,16.1
21-015,2006-01-14,CLE,A,PHO,L,1,44,18,28,.643,13,20,.650,5,8,.625,5,5,1.000,0,7,7,8,1,0,1,1,46,40.9
21-016,2006-01-15,CLE,A,POR,L,1,41,10,26,.385,9,21,.429,1,5,.200,8,11,.727,2,11,13,7,1,3,2,3,29,23.1
21-019,2006-01-18,CLE,A,DEN,L,1,42,7,20,.350,5,14,.357,2,6,.333,8,15,.533,2,9,11,9,0,0,2,5,24,16.4
21-021,2006-01-20,CLE,A,GSW,L,1,35,5,22,.227,5,19,.263,0,3,.000,4,6,.667,1,8,9,6,0,0,6,3,14,-0.1
21-022,2006-01-21,CLE,A,UTA,W,1,43,19,35,.543,15,27,.556,4,8,.500,9,11,.818,0,5,5,8,2,0,3,4,51,37.8
21-025,2006-01-24,CLE,H,IND,W,1,35,7,21,.333,5,16,.313,2,5,.400,7,10,.700,0,7,7,8,2,2,1,0,23,20.0
21-030,2006-01-29,CLE,H,PHO,W,1,43,17,33,.515,14,26,.538,3,7,.429,7,12,.583,1,10,11,7,1,1,6,1,44,29.6
21-031,2006-01-30,CLE,A,CHA,W,1,32,11,19,.579,9,13,.692,2,6,.333,6,11,.545,1,5,6,6,5,1,4,2,30,26.4
21-033,2006-02-01,CLE,H,NJN,W,1,44,8,21,.381,8,19,.421,0,2,.000,10,12,.833,0,11,11,10,1,1,4,2,26,20.9
21-034,2006-02-02,CLE,A,MIA,L,1,39,12,29,.414,10,24,.417,2,5,.400,3,3,1.000,1,4,5,7,1,0,1,0,29,20.3
21-036,2006-02-04,CLE,H,PHI,L,1,47,10,17,.588,8,10,.800,2,7,.286,9,10,.900,2,2,4,6,2,1,4,0,31,27.6
21-038,2006-02-06,CLE,H,MIL,W,1,45,9,20,.450,7,13,.538,2,7,.286,2,4,.500,0,9,9,12,0,2,4,4,22,17.7
21-040,2006-02-08,CLE,A,MIN,W,1,46,11,34,.324,10,29,.345,1,5,.200,12,17,.706,1,10,11,8,1,0,0,3,35,22.7
21-042,2006-02-10,CLE,A,WAS,L,1,45,6,23,.261,6,20,.300,0,3,.000,6,8,.750,1,8,9,8,1,0,2,2,18,10.4
21-043,2006-02-11,CLE,H,GSW,L,1,44,10,17,.588,5,11,.455,5,6,.833,8,8,1.000,1,4,5,6,1,2,2,5,33,29.6
21-045,2006-02-13,CLE,H,SAS,W,1,41,19,33,.576,18,30,.600,1,3,.333,5,8,.625,2,1,3,5,4,0,2,0,44,34.5
21-047,2006-02-15,CLE,A,BOS,W,1,54,16,32,.500,16,27,.593,0,5,.000,11,15,.733,1,11,12,11,2,4,2,5,43,37.9
21-053,2006-02-21,CLE,H,ORL,W,1,43,10,24,.417,9,19,.474,1,5,.200,5,7,.714,0,2,2,9,1,2,2,0,26,19.7
21-054,2006-02-22,CLE,A,PHI,L,1,43,13,24,.542,12,20,.600,1,4,.250,6,10,.600,3,3,6,5,2,1,6,3,33,21.8
21-056,2006-02-24,CLE,H,WAS,L,1,48,7,21,.333,4,13,.308,3,8,.375,8,19,.421,0,7,7,9,1,0,4,2,25,13.3
21-058,2006-02-26,CLE,A,DET,L,1,38,9,20,.450,7,17,.412,2,3,.667,2,3,.667,1,8,9,7,0,0,3,3,22,15.0
21-059,2006-02-27,CLE,H,DET,L,1,47,9,22,.409,9,19,.474,0,3,.000,8,10,.800,1,3,4,6,0,1,5,0,26,14.9
21-061,2006-03-01,CLE,H,SAC,L,1,45,7,21,.333,6,17,.353,1,4,.250,4,7,.571,1,6,7,12,1,2,5,1,19,13.8
21-062,2006-03-02,CLE,A,CHI,W,1,47,11,27,.407,11,24,.458,0,3,.000,11,13,.846,2,9,11,8,0,1,5,4,33,21.5
21-065,2006-03-05,CLE,H,CHI,W,1,46,15,28,.536,14,25,.560,1,3,.333,6,6,1.000,0,9,9,7,2,0,3,3,37,28.8
21-067,2006-03-07,CLE,H,TOR,W,1,44,5,17,.294,3,11,.273,2,6,.333,5,6,.833,1,11,12,8,1,0,2,2,17,14.5
21-068,2006-03-08,CLE,A,TOR,W,1,44,13,24,.542,12,21,.571,1,3,.333,8,12,.667,1,5,6,6,1,0,0,2,35,28.4
21-070,2006-03-10,CLE,A,ORL,L,1,39,9,22,.409,7,16,.438,2,6,.333,5,6,.833,2,5,7,2,2,1,5,0,25,14.8
21-072,2006-03-12,CLE,A,MIA,L,1,45,11,27,.407,10,21,.476,1,6,.167,24,28,.857,2,5,7,4,0,1,5,2,47,31.5
21-074,2006-03-14,CLE,A,DAL,L,1,45,14,27,.519,14,25,.560,0,2,.000,8,8,1.000,1,11,12,5,0,2,4,1,36,27.2
21-077,2006-03-17,CLE,H,POR,W,1,44,9,23,.391,8,17,.471,1,6,.167,8,10,.800,2,7,9,5,6,0,1,2,27,24.9
21-079,2006-03-19,CLE,H,LAL,W,1,47,10,24,.417,7,20,.350,3,4,.750,6,10,.600,1,7,8,7,1,0,7,3,29,15.1
21-082,2006-03-22,CLE,H,CHA,W,1,50,10,21,.476,9,16,.563,1,5,.200,16,23,.696,0,11,11,12,0,1,5,4,37,29.3
21-084,2006-03-24,CLE,H,BOS,W,1,45,13,26,.500,9,18,.500,4,8,.500,6,8,.750,3,4,7,8,2,3,0,2,36,34.4
21-086,2006-03-26,CLE,A,HOU,W,1,49,14,34,.412,14,30,.467,0,4,.000,8,11,.727,3,3,6,5,2,0,2,2,36,22.3
21-089,2006-03-29,CLE,H,DAL,W,1,43,16,23,.696,12,16,.750,4,7,.571,10,13,.769,0,5,5,4,3,0,2,3,46,39.2
21-092,2006-04-01,CLE,H,MIA,W,1,45,16,25,.640,14,19,.737,2,6,.333,13,14,.929,4,8,12,9,2,0,4,3,47,43.8
21-093,2006-04-02,CLE,A,CHA,W,1,41,13,24,.542,11,19,.579,2,5,.400,7,9,.778,1,11,12,8,1,2,3,5,35,29.6
21-095,2006-04-04,CLE,H,PHI,W,1,35,13,22,.591,9,12,.750,4,10,.400,7,9,.778,1,3,4,7,4,0,3,4,37,31.9
21-096,2006-04-05,CLE,A,NYK,L,1,45,12,24,.500,8,17,.471,4,7,.571,8,14,.571,0,2,2,7,3,0,5,3,36,23.9
21-099,2006-04-08,CLE,A,NJN,W,1,44,12,26,.462,12,23,.522,0,3,.000,13,16,.813,1,4,5,7,1,0,6,5,37,22.2
21-101,2006-04-10,CLE,A,NOK,W,1,42,12,24,.500,12,21,.571,0,3,.000,8,12,.667,1,3,4,6,0,0,2,1,32,21.8
21-103,2006-04-12,CLE,A,DET,L,1,31,8,18,.444,8,15,.533,0,3,.000,6,8,.750,0,3,3,1,0,0,2,0,22,11.4
21-107,2006-04-16,CLE,A,WAS,L,1,30,8,16,.500,8,16,.500,0,0,,1,2,.500,0,5,5,4,1,1,3,2,17,10.8
21-306,2006-11-01,CLE,H,WAS,W,1,41,11,24,.458,9,20,.450,2,4,.500,2,6,.333,3,7,10,5,0,2,5,2,26,15.3
21-308,2006-11-03,CLE,A,SAS,W,1,42,14,26,.538,13,24,.542,1,2,.500,6,11,.545,1,9,10,4,1,1,2,3,35,25.1
21-309,2006-11-04,CLE,A,CHA,L,1,38,3,13,.231,2,10,.200,1,3,.333,9,10,.900,4,5,9,7,0,1,2,0,16,15.6
21-312,2006-11-07,CLE,H,ATL,L,1,47,13,26,.500,10,18,.556,3,8,.375,5,11,.455,0,7,7,6,2,1,2,1,34,25.2
21-314,2006-11-09,CLE,H,CHI,W,1,38,6,13,.462,6,12,.500,0,1,.000,7,8,.875,0,4,4,12,3,2,3,0,19,22.9
21-316,2006-11-11,CLE,H,BOS,W,1,44,9,17,.529,8,13,.615,1,4,.250,19,23,.826,1,7,8,5,3,0,2,4,38,33.8
21-318,2006-11-13,CLE,A,NYK,W,1,41,10,19,.526,7,15,.467,3,4,.750,6,9,.667,0,4,4,6,2,1,3,2,29,22.8
21-320,2006-11-15,CLE,H,POR,W,1,39,10,15,.667,7,9,.778,3,6,.500,9,11,.818,0,7,7,7,2,1,4,2,32,29.6
21-322,2006-11-17,CLE,H,MIN,W,1,41,12,24,.500,10,19,.526,2,5,.400,11,14,.786,2,7,9,6,1,2,4,1,37,29.5
21-323,2006-11-18,CLE,A,WAS,L,1,33,8,20,.400,8,19,.421,0,1,.000,4,5,.800,2,3,5,4,2,0,3,2,20,12.1
21-326,2006-11-21,CLE,H,MEM,W,1,42,7,21,.333,6,16,.375,1,5,.200,0,1,.000,0,1,1,9,3,1,3,1,15,9.6
21-327,2006-11-22,CLE,A,TOR,L,1,40,11,24,.458,9,17,.529,2,7,.286,6,9,.667,0,10,10,8,4,0,2,1,30,26.6
21-329,2006-11-24,CLE,A,IND,L,1,42,6,14,.429,4,12,.333,2,2,1.000,16,20,.800,1,6,7,5,1,0,3,6,30,22.6
21-330,2006-11-25,CLE,H,PHI,W,1,41,10,20,.500,9,16,.563,1,4,.250,4,7,.571,0,4,4,11,0,1,7,4,25,14.8
21-334,2006-11-29,CLE,H,NYK,L,1,41,10,22,.455,10,17,.588,0,5,.000,7,11,.636,1,6,7,6,0,1,5,1,27,16.0
21-336,2006-12-01,CLE,A,ATL,W,1,43,12,23,.522,11,20,.550,1,3,.333,6,10,.600,2,5,7,8,3,2,4,4,31,25.4
21-337,2006-12-02,CLE,A,HOU,L,1,36,7,22,.318,5,16,.313,2,6,.333,5,7,.714,1,4,5,4,0,0,3,2,21,8.5
21-341,2006-12-06,CLE,H,TOR,W,1,41,11,18,.611,10,16,.625,1,2,.500,3,5,.600,1,5,6,10,1,0,4,1,26,22.8
21-344,2006-12-09,CLE,H,IND,W,1,32,11,16,.688,10,13,.769,1,3,.333,4,6,.667,0,7,7,6,1,1,3,0,27,24.4
21-346,2006-12-11,CLE,A,NOK,L,1,42,7,18,.389,7,15,.467,0,3,.000,1,1,1.000,3,4,7,6,4,0,3,1,15,13.3
21-348,2006-12-13,CLE,H,CHA,W,1,42,6,17,.353,6,15,.400,0,2,.000,10,11,.909,1,7,8,7,1,1,6,1,22,15.1
21-350,2006-12-15,CLE,H,SEA,W,1,34,9,14,.643,7,11,.636,2,3,.667,2,3,.667,0,9,9,7,1,0,4,3,22,18.8
21-351,2006-12-16,CLE,A,ORL,L,1,41,10,19,.526,8,14,.571,2,5,.400,7,9,.778,1,4,5,5,0,1,4,4,29,19.4
21-355,2006-12-20,CLE,A,NJN,L,1,40,10,22,.455,9,19,.474,1,3,.333,16,21,.762,0,1,1,8,2,1,3,4,37,27.6
21-356,2006-12-21,CLE,H,DET,L,1,43,9,20,.450,9,19,.474,0,1,.000,8,8,1.000,2,8,10,5,2,0,1,1,26,23.5
21-358,2006-12-23,CLE,H,ORL,W,1,43,13,21,.619,11,18,.611,2,3,.667,4,10,.400,0,7,7,1,0,0,7,1,32,15.5
21-362,2006-12-27,CLE,A,ATL,W,1,40,10,25,.400,9,23,.391,1,2,.500,6,8,.750,1,8,9,3,1,2,1,1,27,18.9
21-364,2006-12-29,CLE,H,MIL,W,1,44,11,21,.524,9,15,.600,2,6,.333,8,13,.615,1,3,4,5,1,1,3,5,32,21.5
22-000,2006-12-30,CLE,A,CHI,L,1,40,15,26,.577,12,22,.545,3,4,.750,0,3,.000,2,7,9,3,1,0,5,4,33,19.6
22-003,2007-01-02,CLE,H,SAS,W,1,40,7,17,.412,7,16,.438,0,1,.000,5,11,.455,0,5,5,5,2,0,3,1,19,11.1
22-004,2007-01-03,CLE,A,BOS,W,1,45,11,20,.550,9,17,.529,2,3,.667,8,10,.800,1,5,6,4,3,1,3,0,32,27.3
22-006,2007-01-05,CLE,A,MIL,W,1,43,3,13,.231,3,9,.333,0,4,.000,2,2,1.000,0,5,5,9,1,0,2,1,8,6.5
22-007,2007-01-06,CLE,H,NJN,W,1,44,9,21,.429,8,18,.444,1,3,.333,0,0,,0,13,13,4,3,3,5,4,19,13.1
22-010,2007-01-09,CLE,A,SAC,W,1,43,14,26,.538,11,19,.579,3,7,.429,3,3,1.000,1,3,4,7,2,1,3,3,34,26.4
22-012,2007-01-11,CLE,A,PHO,L,1,39,15,28,.536,12,19,.632,3,9,.333,1,2,.500,2,4,6,6,1,0,5,2,34,22.0
22-014,2007-01-13,CLE,A,LAC,W,1,42,10,23,.435,10,22,.455,0,1,.000,8,8,1.000,1,5,6,6,1,0,2,4,28,19.7
22-017,2007-01-16,CLE,A,SEA,L,1,44,8,21,.381,7,14,.500,1,7,.143,13,15,.867,1,6,7,8,2,1,4,0,30,24.5
22-018,2007-01-17,CLE,A,POR,L,1,35,8,21,.381,7,17,.412,1,4,.250,6,13,.462,3,3,6,2,1,0,4,0,23,10.1
22-020,2007-01-19,CLE,A,DEN,L,1,44,9,23,.391,9,22,.409,0,1,.000,12,14,.857,2,8,10,10,2,0,3,2,30,25.7
22-021,2007-01-20,CLE,A,GSW,W,1,46,14,22,.636,12,15,.800,2,7,.286,2,5,.400,0,7,7,5,4,0,9,2,32,20.8
22-023,2007-01-22,CLE,H,ORL,L,1,43,6,15,.400,6,12,.500,0,3,.000,6,13,.462,0,4,4,5,3,0,2,2,18,12.0
22-025,2007-01-24,CLE,H,PHI,L,1,53,14,26,.538,11,18,.611,3,8,.375,8,13,.615,2,8,10,5,1,0,4,2,39,27.9
22-029,2007-01-28,CLE,H,PHO,L,1,42,12,22,.545,9,16,.563,3,6,.500,3,6,.500,2,7,9,5,2,0,3,2,30,23.4
22-033,2007-02-01,CLE,A,MIA,L,1,36,6,18,.333,4,11,.364,2,7,.286,3,8,.375,1,5,6,9,1,0,2,4,17,10.7
22-034,2007-02-02,CLE,H,CHA,W,1,36,7,13,.538,7,12,.583,0,1,.000,4,8,.500,1,9,10,3,2,0,1,1,18,16.2
22-036,2007-02-04,CLE,H,DET,L,1,43,9,22,.409,8,18,.444,1,4,.250,2,3,.667,0,5,5,6,2,0,3,2,21,12.7
22-039,2007-02-07,CLE,H,LAC,W,1,36,4,13,.308,3,11,.273,1,2,.500,2,2,1.000,0,7,7,3,1,1,2,1,11,7.0
22-041,2007-02-09,CLE,H,MIA,W,1,41,12,22,.545,11,18,.611,1,4,.250,4,8,.500,1,6,7,6,0,0,2,1,29,21.1
22-043,2007-02-11,CLE,H,LAL,W,1,38,5,16,.313,5,14,.357,0,2,.000,8,12,.667,1,7,8,5,1,1,1,3,18,13.0
22-046,2007-02-14,CLE,A,UTA,L,1,43,9,25,.360,9,22,.409,0,3,.000,5,9,.556,3,7,10,4,1,3,0,2,23,16.8
22-047,2007-02-15,CLE,A,LAL,W,1,40,10,16,.625,10,15,.667,0,1,.000,18,22,.818,0,4,4,3,3,0,3,4,38,30.9
22-053,2007-02-21,CLE,A,TOR,W,1,37,12,25,.480,12,24,.500,0,1,.000,5,5,1.000,0,4,4,2,1,1,3,3,29,16.4
22-054,2007-02-22,CLE,H,CHI,L,1,43,13,28,.464,12,24,.500,1,4,.250,2,8,.250,3,4,7,2,3,0,3,1,29,16.5
22-057,2007-02-25,CLE,A,MIA,L,1,42,10,22,.455,8,17,.471,2,5,.400,7,12,.583,0,3,3,7,0,1,2,2,29,19.3
22-059,2007-02-27,CLE,H,NOK,W,1,43,14,22,.636,11,18,.611,3,4,.750,4,7,.571,1,4,5,8,2,1,4,1,35,29.8
22-061,2007-03-01,CLE,A,DAL,L,1,40,17,27,.630,16,23,.696,1,4,.250,4,8,.500,0,3,3,5,0,0,2,2,39,26.9
22-063,2007-03-03,CLE,H,TOR,W,1,37,10,20,.500,9,17,.529,1,3,.333,15,17,.882,2,3,5,6,0,3,2,1,36,31.4
22-065,2007-03-05,CLE,H,HOU,W,1,42,12,24,.500,9,18,.500,3,6,.500,5,9,.556,1,11,12,8,0,0,3,2,32,24.2
22-067,2007-03-07,CLE,A,DET,W,1,51,17,31,.548,16,28,.571,1,3,.333,6,8,.750,2,5,7,8,3,1,4,4,41,31.9
22-070,2007-03-10,CLE,A,MIL,W,1,37,12,22,.545,8,16,.500,4,6,.667,4,4,1.000,0,8,8,9,3,1,6,5,32,25.8
22-077,2007-03-17,CLE,H,UTA,W,1,44,8,21,.381,8,15,.533,0,6,.000,8,13,.615,2,15,17,9,2,2,4,3,24,20.9
22-080,2007-03-20,CLE,A,CHA,L,1,47,12,31,.387,10,22,.455,2,9,.222,11,12,.917,2,4,6,6,1,3,3,4,37,25.0
22-081,2007-03-21,CLE,H,DAL,L,1,45,12,28,.429,11,22,.500,1,6,.167,6,7,.857,0,6,6,4,2,3,6,3,31,17.3
22-083,2007-03-23,CLE,H,NYK,W,1,38,8,16,.500,8,15,.533,0,1,.000,5,6,.833,1,2,3,10,2,0,1,1,21,21.5
22-085,2007-03-25,CLE,H,DEN,L,1,41,8,19,.421,7,13,.538,1,6,.167,1,1,1.000,0,3,3,8,1,0,5,4,18,8.8
22-087,2007-03-27,CLE,A,IND,W,1,40,8,18,.444,8,15,.533,0,3,.000,10,14,.714,1,6,7,6,2,0,3,4,26,19.1
22-088,2007-03-28,CLE,A,NYK,L,1,44,6,20,.300,4,15,.267,2,5,.400,10,14,.714,1,5,6,7,2,0,3,3,24,15.7
22-091,2007-03-31,CLE,A,CHI,W,1,47,14,25,.560,14,22,.636,0,3,.000,11,13,.846,1,4,5,9,3,0,7,4,39,28.9
22-094,2007-04-03,CLE,A,MIN,W,1,42,13,24,.542,13,22,.591,0,2,.000,5,5,1.000,2,10,12,6,4,1,2,1,31,30.3
22-096,2007-04-05,CLE,H,MIA,L,1,49,11,21,.524,9,16,.563,2,5,.400,11,13,.846,2,7,9,5,0,0,4,4,35,25.3
22-097,2007-04-06,CLE,A,WAS,W,1,44,7,23,.304,7,20,.350,0,3,.000,11,14,.786,0,6,6,5,1,1,2,3,25,14.3
22-099,2007-04-08,CLE,A,DET,L,1,43,5,16,.313,4,12,.333,1,4,.250,9,11,.818,1,4,5,6,1,0,5,2,20,11.3
22-103,2007-04-12,CLE,H,NJN,W,1,35,15,27,.556,15,26,.577,0,1,.000,5,9,.556,3,5,8,4,2,1,2,1,35,27.2
22-105,2007-04-14,CLE,H,ATL,W,1,32,8,16,.500,5,10,.500,3,6,.500,4,5,.800,1,4,5,6,1,1,0,1,23,22.0
22-108,2007-04-17,CLE,A,PHI,W,1,36,7,15,.467,7,13,.538,0,2,.000,4,7,.571,1,4,5,6,0,0,1,3,18,13.0
22-109,2007-04-18,CLE,H,MIL,W,1,40,9,18,.500,8,14,.571,1,4,.250,5,10,.500,0,5,5,9,2,0,2,2,24,20.0
22-305,2007-10-31,CLE,H,DAL,L,1,36,2,11,.182,2,9,.222,0,2,.000,6,10,.600,1,4,5,4,1,0,5,4,10,0.6
22-307,2007-11-02,CLE,H,NYK,W,1,44,13,28,.464,10,23,.435,3,5,.600,16,22,.727,3,4,7,7,3,1,3,1,45,36.7
22-309,2007-11-04,CLE,A,PHO,L,1,43,11,26,.423,8,21,.381,3,5,.600,2,2,1.000,1,4,5,8,2,4,3,0,27,22.5
22-311,2007-11-06,CLE,A,GSW,W,1,42,9,16,.563,8,14,.571,1,2,.500,5,7,.714,1,12,13,9,0,3,2,1,24,25.9
22-312,2007-11-07,CLE,A,UTA,L,1,41,12,27,.444,11,23,.478,1,4,.250,7,15,.467,2,13,15,13,3,2,4,4,32,27.9
22-314,2007-11-09,CLE,A,SAC,W,1,44,10,19,.526,10,17,.588,0,2,.000,6,8,.750,0,4,4,4,1,1,1,1,26,20.2
22-316,2007-11-11,CLE,A,LAC,W,1,36,9,21,.429,9,19,.474,0,2,.000,4,8,.500,1,4,5,8,6,1,5,3,22,17.3
22-317,2007-11-12,CLE,A,DEN,L,1,34,9,16,.563,8,13,.615,1,3,.333,8,14,.571,0,1,1,4,2,0,4,3,27,16.9
22-319,2007-11-14,CLE,H,ORL,L,1,47,15,27,.556,13,23,.565,2,4,.500,7,9,.778,4,9,13,14,0,2,4,1,39,37.6
22-321,2007-11-16,CLE,H,UTA,W,1,40,13,27,.481,12,24,.500,1,3,.333,13,15,.867,2,8,10,9,0,3,5,3,40,31.5
22-325,2007-11-20,CLE,H,MIL,L,1,44,11,22,.500,10,15,.667,1,7,.143,11,12,.917,0,7,7,7,1,1,3,4,34,26.7
22-326,2007-11-21,CLE,A,MIN,W,1,39,17,26,.654,11,16,.688,6,10,.600,5,8,.625,2,6,8,5,3,2,3,2,45,39.7
22-329,2007-11-24,CLE,H,TOR,W,1,45,14,29,.483,12,21,.571,2,8,.250,7,8,.875,3,9,12,12,3,1,4,3,37,33.6
22-330,2007-11-25,CLE,A,IND,W,1,36,10,21,.476,9,15,.600,1,6,.167,9,15,.600,3,8,11,10,4,1,2,1,30,30.7
22-332,2007-11-27,CLE,H,BOS,W,1,46,11,25,.440,9,17,.529,2,8,.250,14,15,.933,0,4,4,13,2,2,3,2,38,34.4
22-333,2007-11-28,CLE,A,DET,L,1,20,5,11,.455,5,9,.556,0,2,.000,5,9,.556,0,1,1,3,0,0,0,1,15,9.7
22-346,2007-12-11,CLE,H,IND,W,0,23,5,9,.556,5,8,.625,0,1,.000,7,10,.700,1,2,3,5,1,1,4,2,17,13.2
22-349,2007-12-14,CLE,A,NJN,L,1,41,12,25,.480,9,16,.563,3,9,.333,2,3,.667,0,6,6,8,2,0,6,3,29,18.1
22-350,2007-12-15,CLE,H,PHI,L,1,42,10,18,.556,10,17,.588,0,1,.000,1,1,1.000,0,6,6,6,0,1,3,1,21,15.7
22-352,2007-12-17,CLE,H,MIL,W,1,50,10,25,.400,10,20,.500,0,5,.000,11,13,.846,1,7,8,5,1,0,2,3,31,20.8
22-354,2007-12-19,CLE,A,NYK,L,1,37,12,21,.571,9,15,.600,3,6,.500,5,6,.833,1,7,8,6,6,0,4,1,32,30.3
22-355,2007-12-20,CLE,H,LAL,W,1,38,12,29,.414,12,26,.462,0,3,.000,9,11,.818,4,6,10,5,1,1,3,3,33,22.3
22-358,2007-12-23,CLE,H,GSW,L,1,41,8,20,.400,8,18,.444,0,2,.000,9,13,.692,2,3,5,8,1,1,3,2,25,18.4
22-360,2007-12-25,CLE,H,MIA,W,1,39,9,19,.474,9,16,.563,0,3,.000,7,11,.636,0,6,6,12,1,1,2,3,25,22.4
22-362,2007-12-27,CLE,A,DAL,W,1,36,9,21,.429,8,17,.471,1,4,.250,5,10,.500,4,4,8,7,3,0,3,5,24,17.8
22-364,2007-12-29,CLE,A,NOH,L,1,42,8,21,.381,7,17,.412,1,4,.250,4,6,.667,2,3,5,6,1,0,4,1,21,11.8
23-003,2008-01-02,CLE,H,ATL,W,1,40,13,22,.591,12,19,.632,1,3,.333,9,11,.818,1,4,5,6,2,1,2,1,36,31.4
23-005,2008-01-04,CLE,H,SAC,W,1,45,7,18,.389,6,12,.500,1,6,.167,9,12,.750,1,7,8,10,5,1,3,1,24,25.1
23-007,2008-01-06,CLE,A,TOR,W,1,46,14,29,.483,10,21,.476,4,8,.500,7,12,.583,3,8,11,8,0,0,1,1,39,31.0
23-009,2008-01-08,CLE,H,SEA,W,1,35,8,18,.444,8,15,.533,0,3,.000,6,6,1.000,2,6,8,3,2,0,4,2,22,15.1
23-010,2008-01-09,CLE,A,ATL,L,1,43,13,22,.591,13,18,.722,0,4,.000,5,9,.556,3,7,10,6,3,1,3,3,31,27.1
23-012,2008-01-11,CLE,H,CHA,W,1,50,10,20,.500,8,13,.615,2,7,.286,9,15,.600,5,14,19,8,4,3,8,3,31,28.8
23-016,2008-01-15,CLE,A,MEM,W,1,47,18,28,.643,12,16,.750,6,12,.500,9,16,.563,3,5,8,9,3,1,4,1,51,45.0
23-018,2008-01-17,CLE,A,SAS,W,1,39,9,24,.375,8,19,.421,1,5,.200,8,12,.667,3,6,9,7,0,2,3,1,27,19.0
23-022,2008-01-21,CLE,A,MIA,W,1,40,11,26,.423,10,22,.455,1,4,.250,5,5,1.000,1,2,3,5,4,1,5,4,28,17.1
23-024,2008-01-23,CLE,H,WAS,W,1,31,7,13,.538,6,10,.600,1,3,.333,8,9,.889,2,6,8,8,2,1,0,2,23,27.0
23-026,2008-01-25,CLE,H,PHO,L,1,39,14,30,.467,14,29,.483,0,1,.000,8,10,.800,2,5,7,5,2,0,1,3,36,26.0
23-028,2008-01-27,CLE,A,LAL,W,1,44,16,32,.500,15,27,.556,1,5,.200,8,12,.667,3,6,9,4,2,0,5,4,41,25.5
23-031,2008-01-30,CLE,A,POR,W,1,44,13,29,.448,10,23,.435,3,6,.500,8,12,.667,2,12,14,4,2,2,4,3,37,26.3
23-034,2008-02-02,CLE,H,LAC,W,1,44,8,19,.421,7,15,.467,1,4,.250,11,16,.688,0,11,11,7,2,1,3,2,28,23.0
23-037,2008-02-05,CLE,H,BOS,W,1,42,11,21,.524,7,13,.538,4,8,.500,7,10,.700,1,8,9,12,5,2,7,5,33,30.4
23-039,2008-02-07,CLE,A,HOU,L,1,41,12,23,.522,10,18,.556,2,5,.400,6,11,.545,1,6,7,6,2,2,3,0,32,25.8
23-040,2008-02-08,CLE,A,ATL,W,1,44,11,24,.458,11,21,.524,0,3,.000,4,4,1.000,4,7,11,7,2,1,1,2,26,24.3
23-042,2008-02-10,CLE,H,DEN,L,1,33,11,23,.478,9,18,.500,2,5,.400,6,6,1.000,1,4,5,3,2,0,5,1,30,18.9
23-043,2008-02-11,CLE,A,ORL,W,1,44,8,15,.533,7,13,.538,1,2,.500,12,15,.800,1,6,7,10,3,1,5,3,29,27.5
23-045,2008-02-13,CLE,H,SAS,L,1,43,17,31,.548,16,26,.615,1,5,.200,4,7,.571,2,4,6,9,0,1,3,4,39,27.9
23-051,2008-02-19,CLE,H,HOU,L,1,42,7,18,.389,3,11,.273,4,7,.571,8,11,.727,2,11,13,11,2,0,5,2,26,23.6
23-052,2008-02-20,CLE,A,IND,W,1,43,11,22,.500,10,17,.588,1,5,.200,8,12,.667,2,12,14,12,2,1,4,1,31,30.1
23-054,2008-02-22,CLE,H,WAS,W,1,45,11,20,.550,9,14,.643,2,6,.333,9,14,.643,3,12,15,8,1,1,3,1,33,31.0
23-056,2008-02-24,CLE,H,MEM,W,1,39,10,17,.588,9,13,.692,1,4,.250,4,5,.800,1,6,7,11,3,1,6,2,25,23.8
23-058,2008-02-26,CLE,A,MIL,L,1,38,16,24,.667,15,21,.714,1,3,.333,2,5,.400,0,4,4,6,0,1,2,3,35,26.3
23-059,2008-02-27,CLE,A,BOS,L,1,39,7,24,.292,6,18,.333,1,6,.167,11,15,.733,4,4,8,4,0,0,3,2,26,13.4
23-061,2008-02-29,CLE,H,MIN,W,1,44,11,22,.500,10,18,.556,1,4,.250,7,9,.778,2,6,8,13,2,0,3,2,30,28.7
23-063,2008-03-02,CLE,H,CHI,W,1,40,15,29,.517,15,24,.625,0,5,.000,7,8,.875,3,3,6,6,1,0,3,1,37,27.1
23-066,2008-03-05,CLE,A,NYK,W,1,44,16,30,.533,9,17,.529,7,13,.538,11,16,.688,1,7,8,10,4,0,2,3,50,44.0
23-067,2008-03-06,CLE,A,CHI,L,1,38,13,27,.481,11,19,.579,2,8,.250,11,12,.917,0,3,3,1,1,3,4,1,39,25.2
23-069,2008-03-08,CLE,H,IND,W,1,38,11,24,.458,6,16,.375,5,8,.625,11,12,.917,4,7,11,4,1,2,2,2,38,32.5
23-071,2008-03-10,CLE,H,POR,W,1,44,7,18,.389,6,14,.429,1,4,.250,9,13,.692,1,9,10,11,1,2,4,0,24,22.1
23-073,2008-03-12,CLE,A,NJN,L,1,46,12,23,.522,10,16,.625,2,7,.286,16,23,.696,3,8,11,7,1,2,6,5,42,31.7
23-074,2008-03-13,CLE,A,WAS,L,1,43,9,22,.409,8,15,.533,1,7,.143,6,8,.750,2,5,7,7,0,0,7,4,25,11.6
23-077,2008-03-16,CLE,H,CHA,W,1,42,11,24,.458,10,21,.476,1,3,.333,10,16,.625,2,5,7,10,1,2,1,2,33,28.7
23-078,2008-03-17,CLE,A,ORL,L,1,42,11,22,.500,10,18,.556,1,4,.250,7,11,.636,2,7,9,6,0,1,3,1,30,22.4
23-080,2008-03-19,CLE,H,DET,W,1,41,11,19,.579,9,14,.643,2,5,.400,6,7,.857,3,4,7,6,1,1,0,0,30,29.9
23-082,2008-03-21,CLE,H,TOR,W,1,41,14,22,.636,13,19,.684,1,3,.333,0,0,,0,12,12,5,1,0,5,1,29,21.9
23-083,2008-03-22,CLE,A,MIL,L,1,39,9,25,.360,6,16,.375,3,9,.333,8,10,.800,4,7,11,4,2,0,4,3,29,18.8
23-087,2008-03-26,CLE,H,NOH,L,1,41,6,14,.429,5,12,.417,1,2,.500,8,10,.800,0,3,3,8,2,2,2,2,21,19.9
23-090,2008-03-29,CLE,A,DET,L,1,35,4,17,.235,3,12,.250,1,5,.200,4,6,.667,0,4,4,5,0,0,5,0,13,1.6
23-091,2008-03-30,CLE,H,PHI,W,1,42,11,18,.611,10,16,.625,1,2,.500,3,3,1.000,3,6,9,9,3,1,1,4,26,29.1
23-094,2008-04-02,CLE,A,CHA,W,1,31,11,19,.579,10,15,.667,1,4,.250,6,6,1.000,2,2,4,5,3,2,4,6,29,23.6
23-095,2008-04-03,CLE,H,CHI,L,1,39,10,24,.417,7,17,.412,3,7,.429,10,14,.714,0,5,5,4,2,2,3,4,33,21.7
23-097,2008-04-05,CLE,H,ORL,L,1,42,6,22,.273,5,17,.294,1,5,.200,4,8,.500,5,2,7,9,2,2,5,1,17,10.8
23-101,2008-04-09,CLE,H,NJN,W,1,35,11,21,.524,10,17,.588,1,4,.250,10,13,.769,4,3,7,8,1,2,0,2,33,32.4
23-103,2008-04-11,CLE,A,CHI,L,1,38,13,21,.619,11,15,.733,2,6,.333,6,12,.500,0,6,6,2,3,0,3,2,34,24.5
23-105,2008-04-13,CLE,H,MIA,W,1,35,3,9,.333,3,8,.375,0,1,.000,7,9,.778,0,11,11,7,1,2,5,1,13,12.3
23-106,2008-04-14,CLE,A,PHI,W,1,42,10,18,.556,9,16,.563,1,2,.500,6,12,.500,1,3,4,5,2,1,5,3,27,17.6
23-303,2008-10-28,CLE,A,BOS,L,1,36,9,21,.429,9,17,.529,0,4,.000,4,8,.500,1,6,7,6,2,1,3,4,22,14.1
23-305,2008-10-30,CLE,H,CHA,W,1,30,7,15,.467,7,13,.538,0,2,.000,8,12,.667,2,7,9,9,0,1,5,3,22,17.0
23-307,2008-11-01,CLE,A,NOH,L,1,38,6,15,.400,6,12,.500,0,3,.000,3,4,.750,2,5,7,13,3,0,5,3,15,15.3
23-309,2008-11-03,CLE,A,DAL,W,1,34,8,20,.400,8,18,.444,0,2,.000,13,15,.867,2,6,8,3,2,1,1,1,29,24.0
23-311,2008-11-05,CLE,H,CHI,W,1,36,13,23,.565,13,21,.619,0,2,.000,15,16,.938,2,7,9,6,4,0,5,1,41,36.0
23-313,2008-11-07,CLE,H,IND,W,1,39,11,24,.458,10,18,.556,1,6,.167,4,7,.571,2,7,9,8,1,4,4,2,27,21.5
23-314,2008-11-08,CLE,A,CHI,W,1,39,13,29,.448,9,22,.409,4,7,.571,11,13,.846,4,9,13,4,0,0,2,1,41,31.0
23-321,2008-11-15,CLE,H,UTA,W,1,42,13,21,.619,10,14,.714,3,7,.429,9,11,.818,3,2,5,7,2,2,2,2,38,35.9
23-324,2008-11-18,CLE,A,NJN,W,1,36,9,20,.450,8,16,.500,1,4,.250,12,17,.706,0,8,8,4,0,1,3,3,31,20.3
23-325,2008-11-19,CLE,A,DET,L,1,40,8,21,.381,8,17,.471,0,4,.000,9,10,.900,1,5,6,6,4,0,3,1,25,20.1
23-328,2008-11-22,CLE,H,ATL,W,1,37,8,19,.421,7,15,.467,1,4,.250,7,7,1.000,1,6,7,8,2,0,2,3,24,20.8
23-331,2008-11-25,CLE,A,NYK,W,1,30,7,14,.500,4,7,.571,3,7,.429,9,11,.818,0,4,4,1,1,1,1,0,26,20.8
23-332,2008-11-26,CLE,H,OKC,W,1,17,7,12,.583,7,11,.636,0,1,.000,0,0,,0,3,3,3,1,3,0,0,14,14.5
23-334,2008-11-28,CLE,H,GSW,W,1,31,9,13,.692,6,9,.667,3,4,.750,2,4,.500,1,6,7,8,3,1,2,2,23,25.7
23-335,2008-11-29,CLE,A,MIL,W,1,41,12,27,.444,11,22,.500,1,5,.200,7,10,.700,1,6,7,5,2,1,3,3,32,21.2
23-339,2008-12-03,CLE,H,NYK,W,1,28,5,10,.500,4,6,.667,1,4,.250,10,10,1.000,0,5,5,6,5,1,0,0,21,27.4
23-341,2008-12-05,CLE,H,IND,W,1,38,4,12,.333,4,8,.500,0,4,.000,3,4,.750,2,6,8,11,1,3,2,2,11,15.0
23-342,2008-12-06,CLE,A,CHA,W,1,28,8,17,.471,6,13,.462,2,4,.500,7,8,.875,2,3,5,4,2,2,3,3,25,20.2
23-345,2008-12-09,CLE,H,TOR,W,1,30,11,18,.611,9,13,.692,2,5,.400,7,8,.875,0,5,5,4,3,0,2,1,31,27.3
23-346,2008-12-10,CLE,A,PHI,W,1,39,10,22,.455,8,16,.500,2,6,.333,7,8,.875,2,2,4,5,0,2,1,4,29,21.5
23-348,2008-12-12,CLE,H,PHI,W,1,37,9,21,.429,8,17,.471,1,4,.250,9,12,.750,3,4,7,7,1,3,0,2,28,26.2
23-349,2008-12-13,CLE,A,ATL,L,1,46,10,19,.526,8,12,.667,2,7,.286,11,12,.917,2,4,6,9,4,1,1,2,33,35.1
23-353,2008-12-17,CLE,A,MIN,W,1,40,14,20,.700,12,14,.857,2,6,.333,2,4,.500,0,6,6,3,2,2,0,1,32,29.7
23-355,2008-12-19,CLE,A,DEN,W,1,39,13,20,.650,13,18,.722,0,2,.000,7,8,.875,3,7,10,8,0,0,6,3,33,26.4
23-357,2008-12-21,CLE,A,OKC,W,1,43,14,24,.583,12,20,.600,2,4,.500,1,2,.500,2,2,4,7,3,1,3,1,31,26.6
23-359,2008-12-23,CLE,H,HOU,W,1,38,11,23,.478,11,20,.550,0,3,.000,5,7,.714,1,8,9,5,3,1,7,2,27,17.0
23-361,2008-12-25,CLE,H,WAS,W,1,38,6,13,.462,6,11,.545,0,2,.000,6,10,.600,0,5,5,6,3,1,3,1,18,15.7
23-364,2008-12-28,CLE,H,MIA,W,1,43,12,19,.632,10,15,.667,2,4,.500,7,12,.583,0,6,6,9,0,1,2,1,33,28.9
24-000,2008-12-30,CLE,A,MIA,L,1,43,12,24,.500,9,16,.563,3,8,.375,11,14,.786,0,2,2,7,0,2,5,2,38,25.9
24-003,2009-01-02,CLE,H,CHI,W,1,37,3,8,.375,1,5,.200,2,3,.667,8,8,1.000,1,9,10,11,2,3,5,1,16,21.4
24-005,2009-01-04,CLE,A,WAS,L,1,41,11,22,.500,8,13,.615,3,9,.333,5,8,.625,0,6,6,10,1,2,7,4,30,20.4
24-008,2009-01-07,CLE,H,CHA,W,1,31,9,16,.563,9,15,.600,0,1,.000,3,3,1.000,0,4,4,4,2,2,4,1,21,16.4
24-010,2009-01-09,CLE,H,BOS,W,1,36,13,25,.520,10,18,.556,3,7,.429,9,9,1.000,1,6,7,6,4,3,3,2,38,34.7
24-014,2009-01-13,CLE,A,MEM,W,1,40,9,15,.600,8,10,.800,1,5,.200,11,14,.786,0,11,11,10,3,1,2,2,30,33.1
24-016,2009-01-15,CLE,A,CHI,L,1,44,8,28,.286,7,22,.318,1,6,.167,11,16,.688,3,11,14,7,1,1,8,4,28,12.0
24-017,2009-01-16,CLE,H,NOH,W,1,43,12,24,.500,12,22,.545,0,2,.000,5,6,.833,3,11,14,7,3,1,4,3,29,25.4
24-020,2009-01-19,CLE,A,LAL,L,1,42,9,25,.360,8,20,.400,1,5,.200,4,8,.500,2,7,9,4,4,1,6,1,23,12.1
24-022,2009-01-21,CLE,A,POR,W,1,42,14,30,.467,11,24,.458,3,6,.500,3,4,.750,0,7,7,14,1,0,2,1,34,28.7
24-024,2009-01-23,CLE,A,GSW,W,1,41,10,24,.417,8,19,.421,2,5,.400,10,16,.625,2,7,9,8,3,2,2,2,32,27.5
24-025,2009-01-24,CLE,A,UTA,W,1,41,14,27,.519,13,21,.619,1,6,.167,4,6,.667,4,10,14,9,1,0,2,1,33,29.6
24-028,2009-01-27,CLE,H,SAC,W,1,38,5,10,.500,5,8,.625,0,2,.000,13,15,.867,5,10,15,11,0,3,2,1,23,31.1
24-030,2009-01-29,CLE,A,ORL,L,1,38,10,27,.370,10,25,.400,0,2,.000,3,6,.500,1,7,8,8,1,1,2,1,23,14.6
24-031,2009-01-30,CLE,H,LAC,W,1,37,9,17,.529,7,13,.538,2,4,.500,5,6,.833,0,7,7,6,3,1,3,2,25,22.5
24-033,2009-02-01,CLE,A,DET,W,1,39,12,25,.480,9,17,.529,3,8,.375,6,11,.545,4,0,4,8,1,1,5,3,33,22.2
24-035,2009-02-03,CLE,H,TOR,W,1,38,9,20,.450,7,15,.467,2,5,.400,13,13,1.000,1,6,7,4,1,2,3,3,33,26.1
24-036,2009-02-04,CLE,A,NYK,W,1,44,17,33,.515,15,26,.577,2,7,.286,16,19,.842,0,9,9,11,0,2,3,1,52,42.9
24-040,2009-02-08,CLE,H,LAL,L,1,40,5,20,.250,3,12,.250,2,8,.250,4,8,.500,3,5,8,12,0,0,1,1,16,13.0
24-042,2009-02-10,CLE,A,IND,L,1,41,15,21,.714,11,14,.786,4,7,.571,13,14,.929,0,7,7,4,1,1,7,1,47,37.1
24-043,2009-02-11,CLE,H,PHO,W,1,33,9,18,.500,8,13,.615,1,5,.200,7,8,.875,2,4,6,6,2,1,3,1,26,22.7
24-050,2009-02-18,CLE,A,TOR,W,1,33,9,17,.529,9,14,.643,0,3,.000,2,2,1.000,1,8,9,9,1,1,5,1,20,17.4
24-052,2009-02-20,CLE,A,MIL,W,1,40,16,29,.552,8,18,.444,8,11,.727,15,22,.682,1,4,5,9,0,0,6,3,55,39.3
24-054,2009-02-22,CLE,H,DET,W,1,31,6,13,.462,6,10,.600,0,3,.000,8,10,.800,0,5,5,9,2,1,0,0,20,23.0
24-056,2009-02-24,CLE,H,MEM,W,1,30,4,10,.400,3,8,.375,1,2,.500,6,8,.750,0,5,5,8,0,1,2,1,15,14.2
24-058,2009-02-26,CLE,A,HOU,L,1,34,7,21,.333,5,16,.313,2,5,.400,5,6,.833,0,1,1,0,1,2,3,4,21,6.8
24-059,2009-02-27,CLE,A,SAS,W,1,32,12,23,.522,9,17,.529,3,6,.500,3,3,1.000,4,10,14,4,2,0,1,2,30,27.5
24-061,2009-03-01,CLE,A,ATL,W,1,44,8,20,.400,6,13,.462,2,7,.286,8,14,.571,1,5,6,11,1,2,0,3,26,23.9
24-062,2009-03-02,CLE,A,MIA,W,1,44,13,21,.619,7,14,.500,6,7,.857,10,10,1.000,1,7,8,4,1,1,6,4,42,32.2
24-064,2009-03-04,CLE,H,MIL,W,1,33,7,11,.636,3,6,.500,4,5,.800,5,7,.714,1,7,8,4,1,0,3,2,23,20.1
24-066,2009-03-06,CLE,A,BOS,L,1,38,5,15,.333,3,10,.300,2,5,.400,9,12,.750,0,6,6,5,1,0,4,1,21,13.2
24-067,2009-03-07,CLE,H,MIA,W,1,43,5,15,.333,5,12,.417,0,3,.000,4,7,.571,2,8,10,12,1,1,2,0,14,16.2
24-070,2009-03-10,CLE,A,LAC,W,1,44,10,23,.435,10,17,.588,0,6,.000,12,16,.750,4,9,13,11,2,2,4,2,32,30.1
24-072,2009-03-12,CLE,A,PHO,W,1,43,10,24,.417,7,16,.438,3,8,.375,11,13,.846,6,4,10,13,3,3,3,0,34,37.0
24-073,2009-03-13,CLE,A,SAC,W,1,47,16,30,.533,12,19,.632,4,11,.364,15,17,.882,0,4,4,9,2,3,3,2,51,43.4
24-075,2009-03-15,CLE,H,NYK,W,1,40,9,17,.529,9,14,.643,0,3,.000,1,3,.333,1,7,8,10,4,3,3,1,19,22.4
24-077,2009-03-17,CLE,H,ORL,W,1,43,15,27,.556,11,20,.550,4,7,.571,9,10,.900,2,10,12,8,4,1,6,1,43,38.0
24-079,2009-03-19,CLE,H,POR,W,1,47,10,22,.455,10,19,.526,0,3,.000,6,11,.545,0,11,11,10,1,2,0,4,26,23.7
24-081,2009-03-21,CLE,H,ATL,W,1,40,9,21,.429,8,17,.471,1,4,.250,3,5,.600,1,6,7,5,3,1,2,2,22,17.0
24-082,2009-03-22,CLE,A,NJN,W,1,39,9,17,.529,8,13,.615,1,4,.250,11,15,.733,2,9,11,8,1,0,1,0,30,29.8
24-085,2009-03-25,CLE,H,NJN,W,1,39,7,14,.500,6,13,.462,1,1,1.000,7,7,1.000,1,7,8,11,1,0,1,0,22,25.5
24-087,2009-03-27,CLE,H,MIN,W,1,34,8,14,.571,6,11,.545,2,3,.667,7,10,.700,2,10,12,7,0,0,5,0,25,21.5
24-089,2009-03-29,CLE,H,DAL,W,1,31,9,22,.409,7,18,.389,2,4,.500,4,5,.800,1,5,6,12,1,2,0,0,24,24.8
24-091,2009-03-31,CLE,H,DET,W,1,41,9,24,.375,9,22,.409,0,2,.000,7,8,.875,1,11,12,3,3,1,1,0,25,20.2
24-093,2009-04-02,CLE,A,WAS,L,1,38,11,18,.611,7,10,.700,4,8,.500,5,7,.714,1,8,9,6,0,0,6,1,31,22.9
24-094,2009-04-03,CLE,A,ORL,L,1,32,7,20,.350,5,15,.333,2,5,.400,10,10,1.000,1,8,9,5,1,0,2,1,26,20.0
24-096,2009-04-05,CLE,H,SAS,W,1,37,14,21,.667,12,16,.750,2,5,.400,8,8,1.000,0,7,7,6,1,0,2,1,38,33.8
24-099,2009-04-08,CLE,H,WAS,W,1,31,7,15,.467,7,13,.538,0,2,.000,7,8,.875,0,6,6,7,3,0,2,1,21,20.2
24-101,2009-04-10,CLE,A,PHI,W,1,37,8,17,.471,7,13,.538,1,4,.250,10,12,.833,0,2,2,10,0,1,1,4,27,23.2
24-103,2009-04-12,CLE,H,BOS,W,1,30,9,14,.643,4,6,.667,5,8,.625,6,6,1.000,0,4,4,7,1,1,5,1,29,25.2
24-104,2009-04-13,CLE,A,IND,W,1,39,12,23,.522,10,16,.625,2,7,.286,11,14,.786,0,5,5,5,1,0,5,1,37,25.1
24-301,2009-10-27,CLE,H,BOS,L,1,45,12,22,.545,8,13,.615,4,9,.444,10,13,.769,0,4,4,8,2,4,5,4,38,31.2
24-302,2009-10-28,CLE,A,TOR,L,1,40,7,19,.368,6,14,.429,1,5,.200,8,14,.571,2,9,11,12,2,0,4,1,23,20.2
24-304,2009-10-30,CLE,A,MIN,W,1,33,10,18,.556,8,15,.533,2,3,.667,2,3,.667,2,7,9,6,1,1,2,1,24,22.0
24-305,2009-10-31,CLE,H,CHA,W,1,37,5,11,.455,5,10,.500,0,1,.000,4,6,.667,1,6,7,9,0,0,4,1,14,11.9
24-308,2009-11-03,CLE,H,WAS,W,1,36,7,16,.438,5,9,.556,2,7,.286,11,13,.846,3,5,8,6,3,0,4,0,27,24.6
24-310,2009-11-05,CLE,H,CHI,L,1,38,9,17,.529,8,13,.615,1,4,.250,6,9,.667,0,7,7,6,1,1,3,0,25,20.5
24-311,2009-11-06,CLE,A,NYK,W,1,36,12,17,.706,10,13,.769,2,4,.500,7,9,.778,0,8,8,9,3,0,7,3,33,28.6
24-316,2009-11-11,CLE,A,ORL,W,1,39,13,23,.565,11,20,.550,2,3,.667,8,9,.889,2,6,8,4,1,0,4,2,36,26.9
24-317,2009-11-12,CLE,A,MIA,W,1,39,8,20,.400,6,16,.375,2,4,.500,16,18,.889,1,3,4,7,2,1,2,2,34,28.8
24-319,2009-11-14,CLE,H,UTA,W,1,38,6,15,.400,6,12,.500,0,3,.000,9,12,.750,0,6,6,9,2,1,2,1,21,20.1
24-322,2009-11-17,CLE,H,GSW,W,1,39,11,19,.579,10,14,.714,1,5,.200,8,10,.800,0,5,5,12,1,2,2,2,31,30.8
24-323,2009-11-18,CLE,A,WAS,L,1,35,12,20,.600,9,13,.692,3,7,.429,7,8,.875,0,2,2,9,2,0,6,4,34,25.7
24-325,2009-11-20,CLE,A,IND,W,1,38,13,25,.520,12,22,.545,1,3,.333,13,14,.929,2,7,9,7,1,1,2,1,40,35.0
24-326,2009-11-21,CLE,H,PHI,W,1,39,13,20,.650,11,16,.688,2,4,.500,4,6,.667,0,7,7,9,0,0,5,3,32,24.6
24-330,2009-11-25,CLE,A,DET,W,1,39,12,24,.500,11,20,.550,1,4,.250,9,11,.818,1,7,8,7,1,0,5,2,34,24.1
24-332,2009-11-27,CLE,A,CHA,L,1,38,10,19,.526,8,12,.667,2,7,.286,3,4,.750,0,6,6,4,0,0,6,4,25,12.3
24-333,2009-11-28,CLE,H,DAL,W,1,36,10,20,.500,10,18,.556,0,2,.000,5,7,.714,0,5,5,12,0,0,1,2,25,22.3
24-337,2009-12-02,CLE,H,PHO,W,1,35,6,15,.400,6,12,.500,0,3,.000,0,0,,1,7,8,10,1,1,3,0,12,12.4
24-339,2009-12-04,CLE,H,CHI,W,1,34,8,17,.471,7,14,.500,1,3,.333,6,10,.600,0,6,6,11,0,0,1,1,23,20.8
24-341,2009-12-06,CLE,A,MIL,W,1,32,4,10,.400,4,10,.400,0,0,,6,7,.857,1,4,5,10,1,1,5,2,14,13.0
24-343,2009-12-08,CLE,A,MEM,L,1,45,14,29,.483,10,18,.556,4,11,.364,11,12,.917,4,9,13,6,0,1,5,2,43,32.5
24-344,2009-12-09,CLE,A,HOU,L,1,40,8,21,.381,6,17,.353,2,4,.500,9,10,.900,1,5,6,7,1,1,5,2,27,18.1
24-346,2009-12-11,CLE,H,POR,W,1,38,14,24,.583,13,22,.591,1,2,.500,4,6,.667,1,6,7,7,1,2,4,1,33,26.4
24-348,2009-12-13,CLE,A,OKC,W,1,39,16,29,.552,11,21,.524,5,8,.625,7,10,.700,0,7,7,6,4,1,1,1,44,38.5
24-350,2009-12-15,CLE,H,NJN,W,1,40,9,19,.474,8,14,.571,1,5,.200,4,6,.667,1,5,6,7,2,0,6,3,23,14.4
24-351,2009-12-16,CLE,A,PHI,W,1,40,12,26,.462,9,20,.450,3,6,.500,9,11,.818,1,5,6,7,3,1,3,2,36,28.8
24-356,2009-12-21,CLE,A,PHO,W,1,38,11,21,.524,10,18,.556,1,3,.333,6,6,1.000,1,5,6,4,2,0,3,3,29,21.5
24-358,2009-12-23,CLE,A,SAC,W,1,44,14,30,.467,13,26,.500,1,4,.250,5,7,.714,4,12,16,10,0,0,2,1,34,28.8
24-360,2009-12-25,CLE,A,LAL,W,1,41,9,19,.474,7,12,.583,2,7,.286,6,11,.545,0,4,4,9,2,1,7,3,26,16.3
24-362,2009-12-27,CLE,H,HOU,W,1,29,12,20,.600,10,15,.667,2,5,.400,3,4,.750,2,3,5,6,3,1,1,0,29,28.6
24-364,2009-12-29,CLE,A,ATL,W,1,40,6,20,.300,6,15,.400,0,5,.000,2,3,.667,1,7,8,10,5,1,4,2,14,12.7
25-000,2009-12-30,CLE,H,ATL,W,1,43,15,23,.652,11,17,.647,4,6,.667,14,16,.875,3,7,10,6,2,2,3,3,48,44.7
25-003,2010-01-02,CLE,A,NJN,W,1,36,7,16,.438,6,12,.500,1,4,.250,13,15,.867,1,8,9,7,1,2,1,0,28,28.2
25-004,2010-01-03,CLE,H,CHA,L,1,43,13,21,.619,11,15,.733,2,6,.333,1,2,.500,0,7,7,6,1,1,1,3,29,24.9
25-007,2010-01-06,CLE,H,WAS,W,1,31,7,12,.583,6,8,.750,1,4,.250,8,11,.727,2,5,7,8,1,2,1,0,23,26.1
25-009,2010-01-08,CLE,A,DEN,L,1,41,12,28,.429,10,20,.500,2,8,.250,9,13,.692,2,4,6,7,1,0,8,1,35,18.7
25-011,2010-01-10,CLE,A,POR,W,1,45,13,19,.684,10,15,.667,3,4,.750,12,14,.857,0,10,10,8,0,1,3,1,41,38.0
25-012,2010-01-11,CLE,A,GSW,W,1,42,12,23,.522,11,19,.579,1,4,.250,12,14,.857,1,7,8,11,2,4,2,1,37,37.8
25-015,2010-01-14,CLE,A,UTA,L,1,40,12,20,.600,8,14,.571,4,6,.667,8,12,.667,1,8,9,6,5,1,5,1,36,32.8
25-017,2010-01-16,CLE,A,LAC,W,1,39,12,20,.600,9,14,.643,3,6,.500,5,7,.714,2,2,4,4,2,1,5,3,32,23.3
25-020,2010-01-19,CLE,H,TOR,W,1,41,8,18,.444,8,11,.727,0,7,.000,12,14,.857,0,9,9,11,3,3,3,1,28,29.9
25-022,2010-01-21,CLE,H,LAL,W,1,40,13,25,.520,12,16,.750,1,9,.111,10,13,.769,0,5,5,9,2,1,4,3,37,28.8
25-024,2010-01-23,CLE,H,OKC,W,1,43,9,19,.474,3,9,.333,6,10,.600,13,19,.684,0,9,9,12,1,1,6,2,37,30.9
25-026,2010-01-25,CLE,A,MIA,W,1,39,9,23,.391,7,14,.500,2,9,.222,12,17,.706,0,9,9,4,1,0,4,3,32,18.8
25-028,2010-01-27,CLE,H,MIN,W,1,31,3,8,.375,2,5,.400,1,3,.333,5,6,.833,0,6,6,11,1,1,3,1,12,15.0
25-030,2010-01-29,CLE,A,IND,W,1,36,6,18,.333,6,14,.429,0,4,.000,10,17,.588,0,9,9,13,2,4,5,2,22,19.8
25-032,2010-01-31,CLE,H,LAC,W,1,40,10,20,.500,5,14,.357,5,6,.833,7,8,.875,1,2,3,11,1,0,1,1,32,30.2
25-034,2010-02-02,CLE,H,MEM,W,1,37,7,14,.500,6,10,.600,1,4,.250,7,7,1.000,1,5,6,15,1,1,4,2,22,24.6
25-036,2010-02-04,CLE,H,MIA,W,1,40,9,16,.563,8,12,.667,1,4,.250,17,21,.810,2,5,7,8,2,0,4,1,36,32.9
25-038,2010-02-06,CLE,H,NYK,W,1,44,17,31,.548,11,19,.579,6,12,.500,7,7,1.000,1,7,8,8,5,0,5,2,47,39.7
25-041,2010-02-09,CLE,H,NJN,W,1,42,13,21,.619,12,17,.706,1,4,.250,5,9,.556,0,3,3,11,1,0,3,0,32,27.5
25-043,2010-02-11,CLE,H,ORL,W,1,45,10,21,.476,8,15,.533,2,6,.333,10,12,.833,1,7,8,13,2,0,3,2,32,30.6
25-050,2010-02-18,CLE,H,DEN,L,1,47,15,33,.455,14,24,.583,1,9,.111,12,17,.706,1,12,13,15,2,4,3,1,43,40.1
25-051,2010-02-19,CLE,A,CHA,L,1,36,6,14,.429,4,8,.500,2,6,.333,8,10,.800,1,2,3,9,4,0,2,2,22,22.6
25-053,2010-02-21,CLE,A,ORL,L,1,39,12,25,.480,11,19,.579,1,6,.167,8,12,.667,0,9,9,6,2,1,5,0,33,23.3
25-055,2010-02-23,CLE,H,NOH,W,1,44,7,16,.438,5,10,.500,2,6,.333,4,4,1.000,1,4,5,13,2,0,0,0,20,24.6
25-057,2010-02-25,CLE,A,BOS,W,1,36,11,23,.478,8,17,.471,3,6,.500,11,15,.733,1,6,7,9,0,0,2,2,36,28.7
25-058,2010-02-26,CLE,A,TOR,W,1,44,10,17,.588,9,13,.692,1,4,.250,15,16,.938,0,6,6,9,2,0,1,2,36,36.0
25-061,2010-03-01,CLE,H,NYK,W,1,31,9,17,.529,8,13,.615,1,4,.250,3,5,.600,0,7,7,7,2,2,3,0,22,20.3
25-063,2010-03-03,CLE,A,NJN,W,1,41,10,18,.556,10,14,.714,0,4,.000,6,7,.857,2,5,7,14,3,1,3,1,26,30.0
25-065,2010-03-05,CLE,H,DET,W,1,42,16,27,.593,13,20,.650,3,7,.429,5,6,.833,2,11,13,6,3,2,4,1,40,36.0
25-072,2010-03-12,CLE,A,PHI,W,1,42,7,18,.389,4,8,.500,3,10,.300,6,12,.500,0,6,6,10,1,3,1,2,23,20.9
25-074,2010-03-14,CLE,H,BOS,W,1,39,9,21,.429,8,18,.444,1,3,.333,11,16,.688,3,5,8,7,2,3,2,2,30,26.7
25-076,2010-03-16,CLE,A,DET,W,1,43,10,22,.455,9,19,.474,1,3,.333,8,11,.727,2,10,12,12,1,1,4,0,29,26.9
25-077,2010-03-17,CLE,H,IND,W,1,39,11,24,.458,9,20,.450,2,4,.500,8,10,.800,1,8,9,9,3,2,6,2,32,25.8
25-079,2010-03-19,CLE,A,CHI,W,1,38,9,21,.429,9,18,.500,0,3,.000,11,12,.917,1,10,11,7,2,2,5,1,29,24.1
25-081,2010-03-21,CLE,H,DET,W,1,31,5,9,.556,3,6,.500,2,3,.667,3,3,1.000,0,3,3,7,0,1,0,0,15,17.2
25-084,2010-03-24,CLE,A,NOH,W,1,41,15,22,.682,14,17,.824,1,5,.200,7,8,.875,2,4,6,9,1,0,3,2,38,34.3
25-086,2010-03-26,CLE,A,SAS,L,1,39,11,21,.524,10,15,.667,1,6,.167,4,7,.571,0,5,5,10,2,0,5,2,27,20.2
25-088,2010-03-28,CLE,H,SAC,W,1,39,13,22,.591,10,16,.625,3,6,.500,5,6,.833,1,6,7,8,3,0,3,2,34,30.7
25-091,2010-03-31,CLE,H,MIL,W,1,39,7,17,.412,7,16,.438,0,1,.000,9,13,.692,1,8,9,7,1,1,4,2,23,17.2
25-093,2010-04-02,CLE,H,ATL,W,1,38,11,20,.550,10,17,.588,1,3,.333,4,7,.571,0,13,13,6,2,0,2,1,27,23.9
25-095,2010-04-04,CLE,A,BOS,L,1,45,14,31,.452,14,22,.636,0,9,.000,14,22,.636,1,6,7,9,1,1,3,0,42,30.2
25-097,2010-04-06,CLE,H,TOR,W,1,36,5,13,.385,5,11,.455,0,2,.000,9,10,.900,0,6,6,13,0,1,4,1,19,18.7
25-300,2010-10-26,MIA,A,BOS,L,1,43,10,21,.476,7,15,.467,3,6,.500,8,12,.667,0,4,4,3,1,2,8,1,31,16.0
25-301,2010-10-27,MIA,A,PHI,W,1,38,5,12,.417,5,10,.500,0,2,.000,6,6,1.000,0,6,6,7,2,1,9,1,16,9.6
25-303,2010-10-29,MIA,H,ORL,W,1,30,6,13,.462,4,10,.400,2,3,.667,1,2,.500,0,6,6,7,0,0,3,4,15,10.0
25-305,2010-10-31,MIA,A,NJN,W,1,29,5,12,.417,5,8,.625,0,4,.000,10,12,.833,0,7,7,7,2,0,5,3,20,15.6
25-307,2010-11-02,MIA,H,MIN,W,1,32,7,12,.583,7,10,.700,0,2,.000,6,8,.750,0,0,0,12,2,1,1,0,20,23.7
25-310,2010-11-05,MIA,A,NOH,L,1,41,6,16,.375,5,14,.357,1,2,.500,7,8,.875,0,7,7,10,3,1,3,0,20,20.6
25-311,2010-11-06,MIA,H,NJN,W,1,34,9,16,.563,7,12,.583,2,4,.500,3,5,.600,0,3,3,9,2,0,4,1,23,19.4
25-314,2010-11-09,MIA,H,UTA,L,1,47,5,18,.278,5,17,.294,0,1,.000,10,11,.909,2,9,11,14,1,3,2,3,20,22.8
25-316,2010-11-11,MIA,H,BOS,L,1,44,9,21,.429,9,16,.563,0,5,.000,17,22,.773,0,10,10,9,3,0,4,3,35,29.0
25-318,2010-11-13,MIA,H,TOR,W,1,39,8,21,.381,8,20,.400,0,1,.000,7,11,.636,1,1,2,11,2,0,3,0,23,17.6
25-322,2010-11-17,MIA,H,PHO,W,1,23,9,15,.600,9,13,.692,0,2,.000,2,3,.667,3,5,8,9,3,0,3,5,20,20.6
25-324,2010-11-19,MIA,H,CHA,W,1,39,12,25,.480,10,20,.500,2,5,.400,6,7,.857,0,2,2,5,2,0,4,1,32,20.6
25-325,2010-11-20,MIA,A,MEM,L,1,42,11,23,.478,9,19,.474,2,4,.500,5,6,.833,0,3,3,11,1,0,4,2,29,21.7
25-327,2010-11-22,MIA,H,IND,L,1,42,6,14,.429,4,6,.667,2,8,.250,11,15,.733,0,5,5,6,1,0,6,3,25,15.5
25-329,2010-11-24,MIA,A,ORL,L,1,41,9,18,.500,8,15,.533,1,3,.333,6,8,.750,1,5,6,4,1,0,3,3,25,17.0
25-331,2010-11-26,MIA,H,PHI,W,1,41,5,15,.333,4,10,.400,1,5,.200,9,11,.818,1,7,8,6,2,1,2,1,20,18.0
25-332,2010-11-27,MIA,A,DAL,L,1,36,5,19,.263,5,15,.333,0,4,.000,13,15,.867,2,6,8,4,1,0,5,3,23,11.7
25-334,2010-11-29,MIA,H,WAS,W,1,38,10,18,.556,9,17,.529,1,1,1.000,9,11,.818,1,5,6,5,1,1,7,3,30,19.8
25-336,2010-12-01,MIA,H,DET,W,1,31,8,15,.533,7,14,.500,1,1,1.000,1,2,.500,2,4,6,3,1,0,4,0,18,12.0
25-337,2010-12-02,MIA,A,CLE,W,1,30,15,25,.600,13,18,.722,2,7,.286,6,9,.667,0,5,5,8,1,1,0,1,38,33.7
25-339,2010-12-04,MIA,H,ATL,W,1,37,5,11,.455,4,10,.400,1,1,1.000,11,13,.846,0,7,7,4,1,1,2,1,22,19.7
25-341,2010-12-06,MIA,A,MIL,W,1,39,7,16,.438,6,13,.462,1,3,.333,2,4,.500,0,6,6,6,1,1,1,5,17,12.5
25-343,2010-12-08,MIA,A,UTA,W,1,39,12,20,.600,9,15,.600,3,5,.600,6,7,.857,1,6,7,9,0,0,2,4,33,28.6
25-345,2010-12-10,MIA,A,GSW,W,1,31,10,18,.556,7,14,.500,3,4,.750,2,3,.667,0,7,7,9,1,1,4,1,25,21.7
25-346,2010-12-11,MIA,A,SAC,W,1,35,10,19,.526,8,16,.500,2,3,.667,3,5,.600,1,9,10,3,2,0,3,1,25,19.0
25-348,2010-12-13,MIA,H,NOH,W,1,40,6,16,.375,6,13,.462,0,3,.000,8,10,.800,1,3,4,7,0,0,5,2,20,11.1
25-350,2010-12-15,MIA,H,CLE,W,1,39,5,15,.333,5,11,.455,0,4,.000,11,18,.611,2,11,13,5,1,0,4,1,21,14.5
25-352,2010-12-17,MIA,A,NYK,W,1,38,14,23,.609,11,17,.647,3,6,.500,1,3,.333,1,10,11,10,1,0,5,1,32,27.0
25-353,2010-12-18,MIA,A,WAS,W,1,41,9,19,.474,6,12,.500,3,7,.429,11,12,.917,1,6,7,6,1,0,4,3,32,24.4
25-355,2010-12-20,MIA,H,DAL,L,1,36,6,17,.353,4,13,.308,2,4,.500,5,7,.714,3,7,10,7,0,0,5,4,19,11.2
25-358,2010-12-23,MIA,A,PHO,W,1,37,13,22,.591,11,17,.647,2,5,.400,8,8,1.000,1,5,6,4,3,0,5,5,36,26.8
25-360,2010-12-25,MIA,A,LAL,W,1,38,8,14,.571,3,8,.375,5,6,.833,6,6,1.000,1,10,11,10,4,0,1,2,27,33.3
25-363,2010-12-28,MIA,H,NYK,W,1,40,8,17,.471,7,15,.467,1,2,.500,1,3,.333,0,10,10,8,0,0,3,3,18,12.9
25-364,2010-12-29,MIA,A,HOU,W,1,39,8,15,.533,8,11,.727,0,4,.000,4,4,1.000,0,6,6,9,1,0,3,3,20,17.6
26-002,2011-01-01,MIA,H,GSW,W,1,42,7,15,.467,7,12,.583,0,3,.000,11,17,.647,2,5,7,10,1,1,3,1,25,23.1
26-004,2011-01-03,MIA,A,CHA,W,1,37,15,26,.577,13,22,.591,2,4,.500,6,6,1.000,0,9,9,5,1,0,3,3,38,28.8
26-005,2011-01-04,MIA,H,MIL,W,1,37,8,15,.533,8,15,.533,0,0,,9,11,.818,1,5,6,9,0,2,2,2,25,24.0
26-008,2011-01-07,MIA,A,MIL,W,1,45,8,23,.348,7,19,.368,1,4,.250,9,11,.818,1,9,10,5,6,1,5,2,26,20.1
26-010,2011-01-09,MIA,A,POR,W,1,46,17,26,.654,14,21,.667,3,5,.600,7,10,.700,3,10,13,6,2,0,6,4,44,35.1
26-013,2011-01-12,MIA,A,LAC,L,1,40,11,24,.458,8,18,.444,3,6,.500,2,5,.400,2,6,8,6,0,0,3,1,27,17.4
26-019,2011-01-18,MIA,H,ATL,L,1,44,11,30,.367,9,20,.450,2,10,.200,10,11,.909,2,8,10,7,2,0,6,3,34,20.5
26-023,2011-01-22,MIA,H,TOR,W,1,38,14,29,.483,13,26,.500,1,3,.333,9,14,.643,1,10,11,6,2,1,1,2,38,30.1
26-028,2011-01-27,MIA,A,NYK,L,1,43,7,24,.292,7,22,.318,0,2,.000,10,12,.833,2,9,11,5,2,2,4,3,24,15.0
26-029,2011-01-28,MIA,H,DET,W,1,44,15,25,.600,13,21,.619,2,4,.500,7,10,.700,0,8,8,9,1,2,3,1,39,34.0
26-031,2011-01-30,MIA,A,OKC,W,1,40,7,14,.500,5,9,.556,2,5,.400,7,11,.636,0,4,4,13,4,3,4,3,23,25.6
26-032,2011-01-31,MIA,H,CLE,W,1,31,7,14,.500,7,14,.500,0,0,,10,11,.909,1,3,4,8,0,2,2,1,24,22.8
26-035,2011-02-03,MIA,A,ORL,W,1,43,17,25,.680,14,20,.700,3,5,.600,14,17,.824,2,9,11,8,1,1,3,2,51,46.7
26-036,2011-02-04,MIA,A,CHA,W,1,37,7,13,.538,7,10,.700,0,3,.000,5,6,.833,1,7,8,9,0,0,3,3,19,17.2
26-038,2011-02-06,MIA,H,LAC,W,1,36,6,15,.400,6,13,.462,0,2,.000,0,2,.000,1,5,6,4,4,0,6,2,12,5.3
26-040,2011-02-08,MIA,H,IND,W,1,42,15,23,.652,13,18,.722,2,5,.400,9,13,.692,3,10,13,8,3,1,4,1,41,39.3
26-047,2011-02-15,MIA,A,IND,W,1,41,11,20,.550,10,17,.588,1,3,.333,4,6,.667,1,5,6,5,2,2,5,1,27,20.3
26-048,2011-02-16,MIA,A,TOR,W,1,38,8,18,.444,8,16,.500,0,2,.000,7,10,.700,3,10,13,8,0,0,5,1,23,17.7
26-054,2011-02-22,MIA,H,SAC,W,1,30,14,26,.538,11,20,.550,3,6,.500,0,3,.000,2,6,8,3,0,0,3,4,31,17.9
26-056,2011-02-24,MIA,A,CHI,L,1,41,12,21,.571,12,17,.706,0,4,.000,5,6,.833,0,10,10,5,2,1,2,1,29,25.5
26-057,2011-02-25,MIA,H,WAS,W,1,43,5,11,.455,5,10,.500,0,1,.000,15,19,.789,1,8,9,7,1,3,1,2,25,27.0
26-059,2011-02-27,MIA,H,NYK,L,1,39,10,20,.500,9,15,.600,1,5,.200,6,8,.750,0,7,7,5,3,1,5,2,27,19.7
26-063,2011-03-03,MIA,H,ORL,L,1,40,11,16,.688,11,14,.786,0,2,.000,7,7,1.000,2,4,6,4,0,2,2,2,29,26.2
26-064,2011-03-04,MIA,A,SAS,L,1,36,11,19,.579,10,16,.625,1,3,.333,3,7,.429,3,5,8,7,1,0,4,2,26,20.2
26-066,2011-03-06,MIA,H,CHI,L,1,42,10,18,.556,9,16,.563,1,2,.500,5,6,.833,3,5,8,6,2,0,2,2,26,24.0
26-068,2011-03-08,MIA,H,POR,L,1,46,14,20,.700,12,16,.750,2,4,.500,1,4,.250,1,10,11,8,1,0,4,3,31,26.5
26-070,2011-03-10,MIA,H,LAL,W,1,42,7,17,.412,7,14,.500,0,3,.000,5,7,.714,1,7,8,9,1,0,1,1,19,17.8
26-072,2011-03-12,MIA,H,MEM,W,1,32,10,16,.625,8,12,.667,2,4,.500,5,6,.833,1,4,5,5,1,2,3,1,27,23.8
26-074,2011-03-14,MIA,H,SAS,W,1,42,8,19,.421,8,18,.444,0,1,.000,5,5,1.000,0,6,6,8,0,2,2,3,21,16.5
26-076,2011-03-16,MIA,H,OKC,L,1,40,8,21,.381,8,18,.444,0,3,.000,3,3,1.000,0,8,8,3,1,1,1,0,19,12.7
26-078,2011-03-18,MIA,A,ATL,W,1,31,16,21,.762,11,14,.786,5,7,.714,6,7,.857,0,2,2,3,0,0,4,2,43,32.2
26-079,2011-03-19,MIA,H,DEN,W,1,41,15,25,.600,14,21,.667,1,4,.250,2,2,1.000,0,6,6,2,2,0,5,3,33,20.5
26-083,2011-03-23,MIA,A,DET,W,1,42,8,16,.500,8,13,.615,0,3,.000,3,4,.750,3,5,8,7,0,0,3,3,19,14.9
26-085,2011-03-25,MIA,H,PHI,W,1,41,11,17,.647,10,13,.769,1,4,.250,9,9,1.000,2,8,10,2,3,1,4,3,32,28.2
26-087,2011-03-27,MIA,H,HOU,W,1,40,13,21,.619,13,20,.650,0,1,.000,7,9,.778,1,9,10,7,0,0,2,1,33,28.6
26-089,2011-03-29,MIA,A,CLE,L,1,43,10,21,.476,9,16,.563,1,5,.200,6,10,.600,0,10,10,12,0,0,3,3,27,21.9
26-090,2011-03-30,MIA,A,WAS,W,1,44,12,16,.750,11,13,.846,1,3,.333,10,13,.769,1,7,8,8,5,0,5,3,35,34.6
26-092,2011-04-01,MIA,A,MIN,W,1,43,11,20,.550,11,19,.579,0,1,.000,5,7,.714,2,4,6,10,3,1,3,2,27,26.1
26-094,2011-04-03,MIA,A,NJN,W,1,39,13,18,.722,13,16,.813,0,2,.000,5,8,.625,2,9,11,7,3,0,7,2,31,26.6
26-097,2011-04-06,MIA,H,MIL,L,1,39,10,22,.455,7,15,.467,3,7,.429,6,8,.750,1,1,2,8,2,2,4,2,29,22.0
26-099,2011-04-08,MIA,H,CHA,W,1,37,9,16,.563,9,15,.600,0,1,.000,5,6,.833,1,6,7,9,2,1,1,2,23,24.7
26-101,2011-04-10,MIA,H,BOS,W,1,37,11,19,.579,11,17,.647,0,2,.000,5,9,.556,0,5,5,7,4,1,4,1,27,23.2
26-102,2011-04-11,MIA,A,ATL,W,1,43,10,21,.476,8,17,.471,2,4,.500,12,14,.857,1,9,10,7,3,0,7,1,34,26.4
26-360,2011-12-25,MIA,A,DAL,W,1,36,11,19,.579,11,19,.579,0,0,,15,19,.789,3,7,10,6,2,2,3,3,37,34.1
26-362,2011-12-27,MIA,H,BOS,W,1,36,9,14,.643,9,14,.643,0,0,,8,9,.889,1,5,6,5,2,1,3,3,26,23.6
26-363,2011-12-28,MIA,A,CHA,W,1,39,13,23,.565,13,23,.565,0,0,,9,9,1.000,0,6,6,7,3,2,2,0,35,33.2
27-000,2011-12-30,MIA,A,MIN,W,1,37,16,26,.615,16,25,.640,0,1,.000,2,4,.500,1,7,8,10,4,1,4,2,34,31.1
27-002,2012-01-01,MIA,H,CHA,W,1,28,6,10,.600,6,10,.600,0,0,,4,6,.667,0,9,9,5,1,0,2,2,16,15.0
27-003,2012-01-02,MIA,H,ATL,L,1,39,11,18,.611,11,18,.611,0,0,,6,9,.667,2,5,7,6,0,0,4,1,28,21.3
27-005,2012-01-04,MIA,H,IND,W,1,38,12,21,.571,12,21,.571,0,0,,9,11,.818,2,6,8,13,2,0,2,2,33,33.8
27-008,2012-01-07,MIA,A,NJN,W,1,37,11,17,.647,11,16,.688,0,1,.000,10,12,.833,0,7,7,9,2,1,8,2,32,26.0
27-011,2012-01-10,MIA,A,GSW,L,1,43,10,19,.526,10,17,.588,0,2,.000,6,8,.750,1,10,11,7,2,0,5,1,26,21.1
27-012,2012-01-11,MIA,A,LAC,L,1,42,7,19,.368,7,18,.389,0,1,.000,9,17,.529,2,11,13,7,2,0,6,5,23,12.9
27-014,2012-01-13,MIA,A,DEN,L,1,37,13,20,.650,10,15,.667,3,5,.600,6,11,.545,1,4,5,6,2,1,4,0,35,29.0
27-018,2012-01-17,MIA,H,SAS,W,1,35,12,21,.571,8,15,.533,4,6,.667,5,9,.556,1,4,5,10,0,0,4,0,33,26.4
27-020,2012-01-19,MIA,H,LAL,W,1,37,12,27,.444,10,24,.417,2,3,.667,5,7,.714,3,5,8,8,4,3,3,4,31,26.8
27-022,2012-01-21,MIA,H,PHI,W,1,36,12,17,.706,12,17,.706,0,0,,4,4,1.000,0,9,9,5,4,3,4,1,28,28.8
27-023,2012-01-22,MIA,H,MIL,L,1,37,8,18,.444,8,17,.471,0,1,.000,12,13,.923,4,9,13,5,1,0,3,2,28,24.4
27-025,2012-01-24,MIA,H,CLE,W,1,38,8,21,.381,7,17,.412,1,4,.250,1,4,.250,1,4,5,5,2,0,5,1,18,7.3
27-026,2012-01-25,MIA,A,DET,W,1,42,9,20,.450,8,17,.471,1,3,.333,13,14,.929,1,5,6,7,2,0,4,3,32,25.1
27-028,2012-01-27,MIA,H,NYK,W,1,40,11,18,.611,11,16,.688,0,2,.000,9,10,.900,1,7,8,7,0,0,4,2,31,25.3
27-030,2012-01-29,MIA,H,CHI,W,1,41,12,23,.522,11,22,.500,1,1,1.000,10,15,.667,1,10,11,5,0,1,6,2,35,22.8
27-031,2012-01-30,MIA,H,NOH,W,1,30,8,12,.667,7,10,.700,1,2,.500,5,7,.714,4,7,11,8,1,0,4,1,22,23.1
27-033,2012-02-01,MIA,A,MIL,L,1,40,14,24,.583,10,17,.588,4,7,.571,8,10,.800,0,8,8,5,2,0,7,1,40,28.5
27-035,2012-02-03,MIA,A,PHI,W,1,37,8,16,.500,8,15,.533,0,1,.000,3,6,.500,1,11,12,8,0,2,2,2,19,18.0
27-037,2012-02-05,MIA,H,TOR,W,1,38,10,17,.588,10,16,.625,0,1,.000,10,12,.833,0,9,9,2,1,0,5,1,30,21.0
27-039,2012-02-07,MIA,H,CLE,W,1,39,9,16,.563,9,15,.600,0,1,.000,6,7,.857,1,4,5,6,2,0,6,1,24,17.7
27-040,2012-02-08,MIA,A,ORL,L,1,39,5,15,.333,5,13,.385,0,2,.000,7,10,.700,0,6,6,10,3,0,3,0,17,16.1
27-042,2012-02-10,MIA,A,WAS,W,1,33,6,14,.429,6,12,.500,0,2,.000,6,7,.857,0,2,2,9,0,2,1,1,18,17.1
27-044,2012-02-12,MIA,A,ATL,W,1,30,6,15,.400,5,12,.417,1,3,.333,10,12,.833,3,10,13,6,1,0,2,1,23,22.0
27-045,2012-02-13,MIA,A,MIL,W,1,33,16,21,.762,16,21,.762,0,0,,3,3,1.000,3,5,8,3,1,0,2,3,35,30.2
27-046,2012-02-14,MIA,A,IND,W,1,33,7,15,.467,5,10,.500,2,5,.400,7,8,.875,2,7,9,7,4,0,2,2,23,24.5
27-049,2012-02-17,MIA,A,CLE,W,1,30,11,19,.579,8,14,.571,3,5,.600,3,3,1.000,2,3,5,5,1,1,2,2,28,23.8
27-051,2012-02-19,MIA,H,ORL,W,1,37,9,14,.643,8,12,.667,1,2,.500,6,7,.857,1,10,11,8,2,0,2,2,25,26.9
27-053,2012-02-21,MIA,H,SAC,W,1,33,7,11,.636,5,9,.556,2,2,1.000,2,2,1.000,0,4,4,8,0,2,3,1,18,17.9
27-055,2012-02-23,MIA,H,NYK,W,1,41,7,16,.438,7,16,.438,0,0,,6,6,1.000,1,8,9,8,5,2,4,3,20,21.5
27-062,2012-03-01,MIA,A,POR,W,1,41,13,22,.591,11,20,.550,2,2,1.000,10,12,.833,2,9,11,6,5,1,0,1,38,40.6
27-063,2012-03-02,MIA,A,UTA,L,1,44,16,24,.667,15,20,.750,1,4,.250,2,3,.667,1,9,10,6,0,3,0,2,35,33.1
27-065,2012-03-04,MIA,A,LAL,L,1,43,12,26,.462,12,22,.545,0,4,.000,1,3,.333,7,6,13,7,3,2,3,1,25,23.4
27-067,2012-03-06,MIA,H,NJN,W,1,30,9,11,.818,8,10,.800,1,1,1.000,2,2,1.000,1,8,9,6,0,0,5,0,21,19.2
27-068,2012-03-07,MIA,H,ATL,W,1,42,12,20,.600,12,17,.706,0,3,.000,7,10,.700,4,7,11,2,1,2,2,1,31,26.9
27-071,2012-03-10,MIA,H,IND,W,1,47,8,19,.421,6,16,.375,2,3,.667,9,15,.600,1,7,8,4,4,1,4,1,27,20.4
27-074,2012-03-13,MIA,A,ORL,L,1,42,7,20,.350,5,16,.313,2,4,.500,3,3,1.000,3,8,11,8,1,1,6,0,19,13.6
27-075,2012-03-14,MIA,A,CHI,L,1,40,14,25,.560,12,22,.545,2,3,.667,5,5,1.000,1,4,5,4,4,0,2,2,35,29.0
27-077,2012-03-16,MIA,A,PHI,W,1,38,12,20,.600,12,18,.667,0,2,.000,5,8,.625,2,5,7,8,2,2,1,0,29,29.5
27-079,2012-03-18,MIA,H,ORL,W,1,39,4,14,.286,4,13,.308,0,1,.000,6,8,.750,0,12,12,7,5,0,4,4,14,12.9
27-081,2012-03-20,MIA,H,PHO,W,1,38,8,18,.444,8,15,.533,0,3,.000,4,6,.667,1,7,8,6,2,2,3,2,20,16.4
27-084,2012-03-23,MIA,A,DET,W,1,37,6,15,.400,6,12,.500,0,3,.000,5,5,1.000,0,6,6,10,4,1,5,0,17,17.4
27-086,2012-03-25,MIA,A,OKC,L,1,40,8,18,.444,8,15,.533,0,3,.000,1,1,1.000,0,3,3,7,2,0,4,2,17,10.6
27-087,2012-03-26,MIA,A,IND,L,1,41,9,21,.429,7,17,.412,2,4,.500,4,6,.667,2,7,9,2,1,0,6,1,24,11.6
27-090,2012-03-29,MIA,H,DAL,W,1,36,8,16,.500,8,14,.571,0,2,.000,3,3,1.000,3,6,9,5,2,0,3,3,19,16.2
27-091,2012-03-30,MIA,A,TOR,W,1,39,11,18,.611,11,16,.688,0,2,.000,4,6,.667,1,3,4,9,1,0,3,0,26,22.9
27-093,2012-04-01,MIA,A,BOS,L,1,35,11,20,.550,11,20,.550,0,0,,1,2,.500,2,2,4,0,0,1,2,1,23,13.3
27-095,2012-04-03,MIA,H,PHI,W,1,38,15,25,.600,14,23,.609,1,2,.500,10,13,.769,3,3,6,4,3,1,4,0,41,33.8
27-096,2012-04-04,MIA,H,OKC,W,1,42,10,20,.500,7,13,.538,3,7,.429,11,13,.846,1,6,7,10,4,1,2,2,34,34.6
27-098,2012-04-06,MIA,H,MEM,L,1,38,8,19,.421,6,13,.462,2,6,.333,3,4,.750,2,4,6,6,2,0,3,0,21,16.3
27-100,2012-04-08,MIA,H,DET,W,1,32,12,22,.545,11,19,.579,1,3,.333,1,5,.200,3,1,4,2,0,1,1,1,26,16.9
27-102,2012-04-10,MIA,H,BOS,L,1,41,11,23,.478,10,20,.500,1,3,.333,13,14,.929,5,2,7,7,1,1,2,3,36,31.4
27-104,2012-04-12,MIA,A,CHI,L,1,47,11,24,.458,8,18,.444,3,6,.500,5,7,.714,1,5,6,5,1,1,4,1,30,19.8
27-105,2012-04-13,MIA,H,CHA,W,1,29,7,16,.438,7,15,.467,0,1,.000,5,7,.714,1,8,9,5,2,1,2,1,19,16.7
27-107,2012-04-15,MIA,A,NYK,W,1,40,11,24,.458,10,18,.556,1,6,.167,6,9,.667,2,8,10,3,2,0,6,4,29,15.7
27-108,2012-04-16,MIA,A,NJN,W,1,35,11,19,.579,10,17,.588,1,2,.500,14,15,.933,1,5,6,7,2,1,4,2,37,32.7
27-110,2012-04-18,MIA,H,TOR,W,1,30,12,15,.800,11,14,.786,1,1,1.000,3,4,.750,0,5,5,4,2,0,5,0,28,23.2
27-111,2012-04-19,MIA,H,CHI,W,1,35,8,18,.444,7,16,.438,1,2,.500,10,12,.833,0,11,11,6,0,1,1,3,27,22.8
27-114,2012-04-22,MIA,H,HOU,W,1,36,11,21,.524,10,18,.556,1,3,.333,9,10,.900,1,7,8,5,1,2,5,1,32,24.6
27-305,2012-10-30,MIA,H,BOS,W,1,29,10,16,.625,8,12,.667,2,4,.500,4,5,.800,1,9,10,3,2,0,0,2,26,25.1
27-308,2012-11-02,MIA,A,NYK,L,1,37,8,16,.500,6,13,.462,2,3,.667,5,6,.833,0,7,7,5,0,3,5,2,23,16.5
27-309,2012-11-03,MIA,H,DEN,W,1,39,8,17,.471,8,16,.500,0,1,.000,4,4,1.000,1,8,9,11,0,2,0,2,20,22.7
27-311,2012-11-05,MIA,H,PHO,W,1,30,10,17,.588,8,14,.571,2,3,.667,1,3,.333,3,8,11,1,0,0,3,2,23,15.7
27-313,2012-11-07,MIA,H,BRK,W,1,30,7,12,.583,5,9,.556,2,3,.667,4,4,1.000,4,8,12,8,1,0,2,1,20,23.8
27-315,2012-11-09,MIA,A,ATL,W,1,36,10,17,.588,10,15,.667,0,2,.000,1,3,.333,2,9,11,9,1,0,2,2,21,20.9
27-317,2012-11-11,MIA,A,MEM,L,1,36,10,19,.526,10,18,.556,0,1,.000,0,4,.000,3,7,10,6,2,1,2,2,20,17.4
27-318,2012-11-12,MIA,A,HOU,W,1,40,14,26,.538,9,18,.500,5,8,.625,5,8,.625,1,9,10,6,0,0,0,1,38,31.4
27-327,2012-11-21,MIA,H,MIL,W,1,43,11,21,.524,9,17,.529,2,4,.500,4,8,.500,2,8,10,8,1,1,1,3,28,25.0
27-330,2012-11-24,MIA,H,CLE,W,1,40,10,16,.625,8,11,.727,2,5,.400,8,9,.889,1,5,6,5,0,1,7,3,30,20.6
27-335,2012-11-29,MIA,H,SAS,W,1,39,9,16,.563,7,11,.636,2,5,.400,3,6,.500,3,6,9,7,4,0,4,2,23,22.2
27-337,2012-12-01,MIA,H,BRK,W,1,37,8,15,.533,7,13,.538,1,2,.500,4,6,.667,1,8,9,6,1,0,2,3,21,18.0
27-340,2012-12-04,MIA,A,WAS,L,1,43,12,24,.500,11,20,.550,1,4,.250,1,3,.333,2,11,13,11,3,2,3,1,26,26.6
27-342,2012-12-06,MIA,H,NYK,L,1,39,11,20,.550,8,15,.533,3,5,.600,6,9,.667,2,8,10,9,3,0,2,0,31,31.3
27-344,2012-12-08,MIA,H,NOH,W,1,36,11,16,.688,11,16,.688,0,0,,2,3,.667,1,4,5,7,2,0,4,2,24,20.8
27-346,2012-12-10,MIA,H,ATL,W,1,40,10,16,.625,9,14,.643,1,2,.500,6,7,.857,1,6,7,6,2,0,3,0,27,25.1
27-348,2012-12-12,MIA,H,GSW,L,1,42,12,23,.522,10,19,.526,2,4,.500,5,5,1.000,1,2,3,5,1,0,4,0,31,21.5
27-351,2012-12-15,MIA,H,WAS,W,1,31,8,15,.533,8,12,.667,0,3,.000,7,11,.636,0,10,10,5,1,0,2,0,23,19.6
27-354,2012-12-18,MIA,H,MIN,W,1,42,8,18,.444,6,13,.462,2,5,.400,4,5,.800,0,6,6,11,1,4,0,0,22,25.5
27-356,2012-12-20,MIA,A,DAL,W,1,31,9,13,.692,6,8,.750,3,5,.600,3,4,.750,0,9,9,5,1,1,5,0,24,21.0
27-358,2012-12-22,MIA,H,UTA,W,1,38,11,20,.550,10,19,.526,1,1,1.000,7,10,.700,1,8,9,7,0,0,4,0,30,23.2
27-361,2012-12-25,MIA,H,OKC,W,1,42,12,20,.600,12,17,.706,0,3,.000,5,5,1.000,3,5,8,9,2,1,3,3,29,28.2
27-362,2012-12-26,MIA,A,CHA,W,1,39,9,19,.474,7,15,.467,2,4,.500,7,8,.875,2,10,12,8,4,2,3,1,27,28.9
27-364,2012-12-28,MIA,A,DET,L,1,44,15,22,.682,13,18,.722,2,4,.500,3,4,.750,1,5,6,5,6,1,3,1,35,34.2
27-365,2012-12-29,MIA,A,MIL,L,1,36,11,20,.550,10,18,.556,1,2,.500,3,5,.600,1,5,6,7,2,1,6,2,26,18.6
28-001,2012-12-31,MIA,A,ORL,W,1,48,10,22,.455,9,16,.563,1,6,.167,15,16,.938,1,7,8,11,1,0,3,2,36,31.9
28-003,2013-01-02,MIA,H,DAL,W,1,42,11,20,.550,10,17,.588,1,3,.333,9,11,.818,1,11,12,9,3,1,4,0,32,31.6
28-005,2013-01-04,MIA,H,CHI,L,1,41,8,14,.571,7,9,.778,1,5,.200,13,16,.813,0,6,6,2,1,0,2,2,30,23.6
28-007,2013-01-06,MIA,H,WAS,W,1,35,9,17,.529,7,14,.500,2,3,.667,4,4,1.000,1,1,2,7,0,1,1,0,24,21.3
28-009,2013-01-08,MIA,A,IND,L,1,43,10,20,.500,9,19,.474,1,1,1.000,1,4,.250,3,7,10,4,1,2,7,2,22,12.4
28-011,2013-01-10,MIA,A,POR,L,1,43,6,16,.375,5,11,.455,1,5,.200,2,5,.400,0,10,10,9,2,1,4,3,15,11.8
28-013,2013-01-12,MIA,A,SAC,W,1,29,7,10,.700,7,9,.778,0,1,.000,6,7,.857,1,4,5,7,5,2,1,0,20,27.6
28-015,2013-01-14,MIA,A,UTA,L,1,44,13,19,.684,11,15,.733,2,4,.500,4,4,1.000,1,3,4,6,3,2,3,5,32,29.1
28-017,2013-01-16,MIA,A,GSW,W,1,31,11,20,.550,10,15,.667,1,5,.200,2,3,.667,1,6,7,10,1,0,1,2,25,23.7
28-018,2013-01-17,MIA,A,LAL,W,1,42,17,25,.680,16,23,.696,1,2,.500,4,4,1.000,0,7,7,8,3,1,2,2,39,36.9
28-024,2013-01-23,MIA,H,TOR,W,1,45,12,23,.522,11,18,.611,1,5,.200,6,7,.857,1,9,10,11,0,0,3,1,31,27.0
28-026,2013-01-25,MIA,H,DET,W,1,33,9,14,.643,9,13,.692,0,1,.000,5,6,.833,1,6,7,7,1,0,2,0,23,22.8
28-028,2013-01-27,MIA,A,BOS,L,1,52,14,31,.452,11,25,.440,3,6,.500,3,5,.600,4,12,16,7,3,1,3,3,34,27.9
28-031,2013-01-30,MIA,A,BRK,W,1,34,10,18,.556,7,14,.500,3,4,.750,1,4,.250,2,7,9,7,2,0,4,2,24,19.8
28-033,2013-02-01,MIA,A,IND,L,1,42,9,17,.529,8,14,.571,1,3,.333,9,11,.818,1,5,6,3,1,1,3,4,28,20.3
28-035,2013-02-03,MIA,A,TOR,W,1,40,10,16,.625,9,14,.643,1,2,.500,9,11,.818,0,8,8,7,2,0,3,1,30,27.9
28-036,2013-02-04,MIA,H,CHA,W,1,38,13,14,.929,13,14,.929,0,0,,5,6,.833,0,8,8,8,2,0,5,1,31,30.6
28-038,2013-02-06,MIA,H,HOU,W,1,37,11,18,.611,8,12,.667,3,6,.500,7,10,.700,1,5,6,5,0,2,4,2,32,24.9
28-040,2013-02-08,MIA,H,LAC,W,1,31,9,11,.818,5,6,.833,4,5,.800,8,11,.727,1,4,5,6,0,2,5,3,30,26.0
28-042,2013-02-10,MIA,H,LAL,W,1,36,12,18,.667,11,16,.688,1,2,.500,7,8,.875,1,6,7,4,3,0,4,4,32,26.5
28-044,2013-02-12,MIA,H,POR,W,1,39,11,15,.733,10,12,.833,1,3,.333,7,8,.875,0,6,6,9,3,2,1,0,30,35.0
28-046,2013-02-14,MIA,A,OKC,W,1,40,14,24,.583,10,16,.625,4,8,.500,7,9,.778,3,9,12,7,2,0,4,3,39,33.5
28-052,2013-02-20,MIA,A,ATL,W,1,40,8,15,.533,7,11,.636,1,4,.250,7,8,.875,0,6,6,11,4,0,2,1,24,27.4
28-053,2013-02-21,MIA,A,CHI,W,1,34,11,15,.733,10,11,.909,1,4,.250,3,3,1.000,1,11,12,7,2,0,4,2,26,26.0
28-055,2013-02-23,MIA,A,PHI,W,1,32,7,12,.583,6,8,.750,1,4,.250,1,2,.500,1,9,10,11,2,0,2,1,16,20.7
28-056,2013-02-24,MIA,H,CLE,W,1,39,10,19,.526,10,18,.556,0,1,.000,8,11,.727,2,1,3,8,1,0,2,0,28,23.8
28-058,2013-02-26,MIA,H,SAC,W,1,48,14,23,.609,13,21,.619,1,2,.500,11,12,.917,3,5,8,16,2,1,2,1,40,44.2
28-061,2013-03-01,MIA,H,MEM,W,1,42,4,14,.286,2,10,.200,2,4,.500,8,12,.667,1,7,8,10,2,1,1,1,18,19.3
28-063,2013-03-03,MIA,A,NYK,W,1,43,12,23,.522,10,17,.588,2,6,.333,3,6,.500,3,8,11,7,3,1,2,1,29,27.2
28-064,2013-03-04,MIA,A,MIN,W,1,35,9,16,.563,8,12,.667,1,4,.250,1,1,1.000,1,9,10,4,3,2,7,3,20,14.8
28-066,2013-03-06,MIA,H,ORL,W,1,38,7,14,.500,6,8,.750,1,6,.167,11,12,.917,0,3,3,2,0,1,2,0,26,19.6
28-068,2013-03-08,MIA,H,PHI,W,1,34,10,17,.588,8,14,.571,2,3,.667,3,5,.600,3,7,10,5,1,2,3,2,25,22.6
28-070,2013-03-10,MIA,H,IND,W,1,36,5,10,.500,5,10,.500,0,0,,3,5,.600,1,5,6,7,1,1,4,1,13,11.6
28-072,2013-03-12,MIA,H,ATL,W,1,30,3,11,.273,3,9,.333,0,2,.000,9,12,.750,3,4,7,7,2,0,4,1,15,13.1
28-073,2013-03-13,MIA,A,PHI,W,1,37,8,19,.421,7,15,.467,1,4,.250,10,12,.833,2,5,7,8,2,1,4,1,27,22.9
28-075,2013-03-15,MIA,A,MIL,W,1,38,12,24,.500,12,22,.545,0,2,.000,4,5,.800,1,9,10,7,0,1,2,1,28,22.2
28-077,2013-03-17,MIA,A,TOR,W,1,34,6,12,.500,4,6,.667,2,6,.333,8,11,.727,1,11,12,8,2,0,3,1,22,23.0
28-078,2013-03-18,MIA,A,BOS,W,1,42,16,29,.552,15,25,.600,1,4,.250,4,6,.667,1,6,7,12,2,2,5,3,37,30.4
28-080,2013-03-20,MIA,A,CLE,W,1,42,8,22,.364,5,15,.333,3,7,.429,6,8,.750,7,5,12,10,3,2,4,1,25,25.4
28-082,2013-03-22,MIA,H,DET,W,1,40,12,15,.800,11,14,.786,1,1,1.000,4,6,.667,1,7,8,8,2,1,3,1,29,30.2
28-084,2013-03-24,MIA,H,CHA,W,1,34,11,14,.786,11,13,.846,0,1,.000,10,11,.909,0,8,8,10,3,3,4,0,32,36.7
28-085,2013-03-25,MIA,A,ORL,W,1,39,9,16,.563,9,16,.563,0,0,,6,10,.600,1,8,9,11,1,0,3,2,24,22.8
28-087,2013-03-27,MIA,A,CHI,L,1,40,11,17,.647,9,12,.750,2,5,.400,8,11,.727,0,7,7,3,2,4,4,1,32,27.9
28-089,2013-03-29,MIA,A,NOH,W,1,32,13,20,.650,6,10,.600,7,10,.700,3,5,.600,0,4,4,6,2,0,3,0,36,30.8
28-097,2013-04-06,MIA,H,PHI,W,1,30,12,17,.706,11,15,.733,1,2,.500,2,2,1.000,0,4,4,5,1,0,1,1,27,24.2
28-100,2013-04-09,MIA,H,MIL,W,1,30,11,16,.688,11,15,.733,0,1,.000,6,6,1.000,1,6,7,7,2,1,3,0,28,28.3
28-103,2013-04-12,MIA,H,BOS,W,1,29,8,10,.800,8,10,.800,0,0,,4,4,1.000,1,5,6,9,0,0,1,1,20,23.3
28-105,2013-04-14,MIA,H,CHI,W,1,35,7,12,.583,6,11,.545,1,1,1.000,9,12,.750,0,7,7,6,1,0,3,2,24,20.7
28-303,2013-10-29,MIA,H,CHI,W,1,38,5,11,.455,5,10,.500,0,1,.000,7,9,.778,0,6,6,8,1,0,2,0,17,16.9
28-304,2013-10-30,MIA,A,PHI,L,1,37,9,17,.529,5,10,.500,4,7,.571,3,4,.750,0,4,4,13,0,0,4,3,25,21.4
28-306,2013-11-01,MIA,A,BRK,L,1,42,11,19,.579,10,17,.588,1,2,.500,3,5,.600,1,6,7,6,2,1,5,2,26,19.9
28-308,2013-11-03,MIA,H,WAS,W,1,35,9,14,.643,6,9,.667,3,5,.600,4,5,.800,0,3,3,5,1,0,6,2,25,17.0
28-310,2013-11-05,MIA,A,TOR,W,1,36,13,20,.650,12,17,.706,1,3,.333,8,8,1.000,2,6,8,8,0,1,1,2,35,33.9
28-312,2013-11-07,MIA,H,LAC,W,1,37,6,13,.462,5,10,.500,1,3,.333,5,9,.556,0,5,5,6,1,0,4,4,18,10.8
28-314,2013-11-09,MIA,H,BOS,L,1,37,9,13,.692,9,13,.692,0,0,,7,9,.778,1,7,8,10,0,0,5,1,25,23.1
28-317,2013-11-12,MIA,H,MIL,W,1,30,13,21,.619,9,14,.643,4,7,.571,3,6,.500,0,3,3,2,0,0,3,0,33,21.6
28-320,2013-11-15,MIA,H,DAL,W,1,37,14,18,.778,13,17,.765,1,1,1.000,10,11,.909,0,6,6,4,1,0,6,0,39,31.2
28-321,2013-11-16,MIA,A,CHA,W,1,32,13,18,.722,13,18,.722,0,0,,4,4,1.000,1,3,4,7,1,1,3,1,30,27.4
28-324,2013-11-19,MIA,H,ATL,W,1,31,6,13,.462,6,13,.462,0,0,,1,3,.333,2,4,6,5,1,0,3,0,13,9.6
28-325,2013-11-20,MIA,A,ORL,W,1,29,5,11,.455,5,9,.556,0,2,.000,11,11,1.000,1,5,6,7,1,1,4,0,21,20.1
28-328,2013-11-23,MIA,H,ORL,W,1,38,7,13,.538,4,7,.571,3,6,.500,5,7,.714,0,9,9,7,3,0,3,0,22,22.5
28-330,2013-11-25,MIA,H,PHO,W,1,33,11,14,.786,9,10,.900,2,4,.500,11,11,1.000,0,5,5,4,1,1,4,0,35,31.6
28-332,2013-11-27,MIA,A,CLE,W,1,37,9,19,.474,8,16,.500,1,3,.333,9,11,.818,0,8,8,8,3,0,1,3,28,26.3
28-334,2013-11-29,MIA,A,TOR,W,1,36,10,17,.588,7,12,.583,3,5,.600,4,6,.667,1,5,6,3,1,1,3,2,27,20.5
28-336,2013-12-01,MIA,H,CHA,W,1,38,8,13,.615,7,10,.700,1,3,.333,9,10,.900,0,5,5,4,1,1,3,0,26,22.7
28-338,2013-12-03,MIA,H,DET,L,1,37,8,15,.533,6,10,.600,2,5,.400,5,8,.625,3,2,5,6,2,1,6,2,23,17.3
28-340,2013-12-05,MIA,A,CHI,L,1,33,7,17,.412,6,13,.462,1,4,.250,6,8,.750,0,5,5,2,3,0,1,2,21,15.2
28-342,2013-12-07,MIA,A,MIN,W,1,31,9,12,.750,9,12,.750,0,0,,3,5,.600,4,10,14,8,2,0,7,3,21,20.6
28-343,2013-12-08,MIA,A,DET,W,1,35,10,15,.667,10,13,.769,0,2,.000,4,5,.800,1,6,7,9,2,0,6,2,24,21.1
28-345,2013-12-10,MIA,A,IND,L,1,39,6,16,.375,5,12,.417,1,4,.250,4,6,.667,1,13,14,6,2,0,5,3,17,12.0
28-349,2013-12-14,MIA,H,CLE,W,1,41,9,12,.750,9,10,.900,0,2,.000,7,10,.700,2,7,9,9,4,0,2,2,25,30.0
28-351,2013-12-16,MIA,H,UTA,W,1,34,13,17,.765,13,16,.813,0,1,.000,4,5,.800,1,8,9,9,1,0,3,1,30,29.9
28-353,2013-12-18,MIA,H,IND,W,1,36,8,14,.571,7,11,.636,1,3,.333,7,7,1.000,0,9,9,7,3,0,3,3,24,23.8
28-355,2013-12-20,MIA,H,SAC,W,1,31,8,11,.727,7,9,.778,1,2,.500,1,2,.500,2,4,6,8,1,1,1,1,18,21.6
28-358,2013-12-23,MIA,H,ATL,W,1,46,16,28,.571,12,19,.632,4,9,.444,2,6,.333,4,4,8,6,2,0,0,2,38,32.6
28-360,2013-12-25,MIA,A,LAL,W,1,36,7,14,.500,7,10,.700,0,4,.000,5,9,.556,0,8,8,4,0,0,2,2,19,12.8
28-362,2013-12-27,MIA,A,SAC,L,1,44,12,23,.522,8,14,.571,4,9,.444,5,6,.833,0,8,8,8,0,0,2,3,33,26.1
29-000,2013-12-30,MIA,A,DEN,W,1,40,8,15,.533,3,6,.500,5,9,.556,5,8,.625,1,5,6,10,0,1,4,0,26,23.4
29-003,2014-01-02,MIA,H,GSW,L,1,40,10,16,.625,9,12,.750,1,4,.250,5,8,.625,0,5,5,5,0,1,8,0,26,15.3
29-005,2014-01-04,MIA,A,ORL,W,1,36,5,13,.385,5,12,.417,0,1,.000,5,8,.625,1,7,8,8,1,0,3,1,15,12.7
29-011,2014-01-10,MIA,A,BRK,L,1,49,12,21,.571,10,16,.625,2,5,.400,10,12,.833,3,4,7,5,0,0,4,6,36,25.7
29-016,2014-01-15,MIA,A,WAS,L,1,41,8,18,.444,8,14,.571,0,4,.000,9,10,.900,2,6,8,7,2,0,4,1,25,20.9
29-018,2014-01-17,MIA,A,PHI,W,1,37,7,13,.538,7,12,.583,0,1,.000,7,8,.875,1,7,8,10,2,1,3,3,21,22.6
29-019,2014-01-18,MIA,A,CHA,W,1,45,13,25,.520,13,22,.591,0,3,.000,8,10,.800,2,6,8,6,1,0,2,4,34,25.7
29-021,2014-01-20,MIA,A,ATL,L,1,39,11,21,.524,8,14,.571,3,7,.429,5,8,.625,1,3,4,6,1,0,3,1,30,21.9
29-022,2014-01-21,MIA,H,BOS,W,1,39,10,19,.526,10,15,.667,0,4,.000,9,11,.818,1,7,8,4,2,0,3,1,29,23.1
29-024,2014-01-23,MIA,H,LAL,W,1,37,9,15,.600,7,11,.636,2,4,.500,7,13,.538,2,11,13,6,1,0,5,1,27,22.2
29-027,2014-01-26,MIA,H,SAS,W,1,28,8,15,.533,7,12,.583,1,3,.333,1,1,1.000,0,7,7,6,1,0,4,4,18,12.4
29-030,2014-01-29,MIA,H,OKC,L,1,42,12,20,.600,11,15,.733,1,5,.200,9,9,1.000,1,2,3,3,0,0,3,1,34,24.8
29-033,2014-02-01,MIA,A,NYK,W,1,39,13,22,.591,12,19,.632,1,3,.333,3,6,.500,1,7,8,7,6,0,2,3,30,29.1
29-035,2014-02-03,MIA,H,DET,W,1,38,9,19,.474,9,16,.563,0,3,.000,6,8,.750,1,7,8,11,2,2,1,1,24,26.0
29-037,2014-02-05,MIA,A,LAC,W,1,41,11,20,.550,8,13,.615,3,7,.429,6,8,.750,1,7,8,12,3,1,7,2,31,27.7
29-040,2014-02-08,MIA,A,UTA,L,1,39,4,13,.308,3,7,.429,1,6,.167,4,6,.667,0,7,7,5,0,0,5,2,13,4.5
29-043,2014-02-11,MIA,A,PHO,W,1,41,12,22,.545,10,17,.588,2,5,.400,11,14,.786,1,8,9,3,5,0,4,2,37,30.6
29-044,2014-02-12,MIA,A,GSW,W,1,42,14,26,.538,10,18,.556,4,8,.500,4,7,.571,1,12,13,9,2,0,2,1,36,32.4
29-050,2014-02-18,MIA,A,DAL,W,1,38,16,23,.696,12,15,.800,4,8,.500,6,8,.750,2,7,9,6,2,0,3,2,42,37.4
29-052,2014-02-20,MIA,A,OKC,W,1,33,15,22,.682,14,17,.824,1,5,.200,2,5,.400,1,6,7,3,4,0,8,1,33,22.6
29-059,2014-02-27,MIA,H,NYK,W,1,37,13,19,.684,12,17,.706,1,2,.500,4,6,.667,0,4,4,4,0,0,1,0,31,25.1
29-061,2014-03-01,MIA,H,ORL,W,1,31,8,12,.667,8,10,.800,0,2,.000,4,5,.800,1,8,9,7,4,0,2,1,20,24.0
29-063,2014-03-03,MIA,H,CHA,W,1,41,22,33,.667,14,23,.609,8,10,.800,9,12,.750,3,4,7,4,0,0,2,2,61,48.8
29-064,2014-03-04,MIA,A,HOU,L,1,37,9,18,.500,9,15,.600,0,3,.000,4,6,.667,1,0,1,6,3,0,1,1,22,18.7
29-066,2014-03-06,MIA,A,SAS,L,1,38,6,18,.333,6,15,.400,0,3,.000,7,9,.778,3,5,8,7,2,0,5,5,19,11.5
29-069,2014-03-09,MIA,A,CHI,L,1,45,8,23,.348,7,20,.350,1,3,.333,0,0,,1,8,9,8,3,1,4,1,17,12.1
29-070,2014-03-10,MIA,H,WAS,W,1,37,10,15,.667,7,11,.636,3,4,.750,0,0,,2,5,7,8,3,0,3,3,23,23.8
29-072,2014-03-12,MIA,H,BRK,L,1,38,6,13,.462,5,9,.556,1,4,.250,6,9,.667,0,5,5,7,3,0,5,1,19,15.1
29-074,2014-03-14,MIA,H,DEN,L,1,40,8,17,.471,8,13,.615,0,4,.000,5,7,.714,0,6,6,6,1,0,4,3,21,13.3
29-076,2014-03-16,MIA,H,HOU,W,1,43,8,17,.471,7,14,.500,1,3,.333,7,8,.875,0,5,5,6,2,0,5,3,24,16.4
29-078,2014-03-18,MIA,A,CLE,W,1,42,14,19,.737,8,11,.727,6,8,.750,9,13,.692,0,6,6,4,2,3,0,1,43,42.0
29-081,2014-03-21,MIA,H,MEM,W,1,38,7,14,.500,7,12,.583,0,2,.000,1,2,.500,1,5,6,7,2,1,3,0,15,14.4
29-082,2014-03-22,MIA,A,NOP,L,1,42,10,18,.556,8,14,.571,2,4,.500,3,3,1.000,1,7,8,9,0,1,3,1,25,22.8
29-084,2014-03-24,MIA,H,POR,W,1,38,13,23,.565,13,22,.591,0,1,.000,6,9,.667,4,2,6,5,4,0,5,2,32,25.0
29-086,2014-03-26,MIA,A,IND,L,1,43,11,19,.579,9,13,.692,2,6,.333,14,15,.933,0,8,8,5,0,0,6,3,38,27.4
29-088,2014-03-28,MIA,A,DET,W,1,30,7,13,.538,6,10,.600,1,3,.333,2,2,1.000,2,8,10,12,1,0,1,0,17,22.9
29-089,2014-03-29,MIA,A,MIL,W,1,30,5,10,.500,4,7,.571,1,3,.333,2,4,.500,2,5,7,2,0,0,4,1,13,7.1
29-091,2014-03-31,MIA,H,TOR,W,1,39,11,20,.550,10,14,.714,1,6,.167,9,11,.818,0,7,7,8,1,0,6,2,32,23.5
29-093,2014-04-02,MIA,H,MIL,W,1,29,7,12,.583,6,9,.667,1,3,.333,2,5,.400,0,4,4,8,1,1,2,0,17,16.7
29-095,2014-04-04,MIA,H,MIN,L,1,48,12,24,.500,10,20,.500,2,4,.500,8,10,.800,2,6,8,5,4,1,4,5,34,26.6
29-097,2014-04-06,MIA,H,NYK,W,1,43,13,22,.591,10,15,.667,3,7,.429,9,12,.750,0,5,5,6,1,0,5,0,38,28.3
29-099,2014-04-08,MIA,H,BRK,L,1,37,9,16,.563,9,13,.692,0,3,.000,11,14,.786,1,9,10,6,2,0,3,0,29,26.8
29-100,2014-04-09,MIA,A,MEM,L,1,41,14,23,.609,11,18,.611,3,5,.600,6,7,.857,1,5,6,5,2,0,5,1,37,28.4
29-102,2014-04-11,MIA,H,IND,W,1,35,11,20,.550,9,16,.563,2,4,.500,12,13,.923,1,5,6,1,1,1,2,1,36,28.2
29-103,2014-04-12,MIA,A,ATL,L,1,37,10,22,.455,7,15,.467,3,7,.429,4,8,.500,3,5,8,5,0,1,3,2,27,18.0
29-304,2014-10-30,CLE,H,NYK,L,1,43,5,15,.333,4,10,.400,1,5,.200,6,7,.857,0,5,5,4,0,0,8,3,17,3.2
29-305,2014-10-31,CLE,A,CHI,W,1,42,14,30,.467,13,27,.481,1,3,.333,7,9,.778,1,7,8,5,4,1,3,1,36,27.4
29-309,2014-11-04,CLE,A,POR,L,1,35,4,12,.333,2,8,.250,2,4,.500,1,1,1.000,1,6,7,7,1,0,3,2,11,8.8
29-310,2014-11-05,CLE,A,UTA,L,1,42,8,18,.444,5,13,.385,3,5,.600,12,12,1.000,0,3,3,4,3,0,4,2,31,23.5
29-312,2014-11-07,CLE,A,DEN,W,1,40,8,18,.444,7,13,.538,1,5,.200,5,6,.833,0,7,7,11,1,1,3,1,22,20.3
29-315,2014-11-10,CLE,H,NOP,W,1,40,9,17,.529,8,14,.571,1,3,.333,13,17,.765,2,9,11,9,1,1,4,1,32,29.8
29-319,2014-11-14,CLE,A,BOS,W,1,41,16,27,.593,13,19,.684,3,8,.375,6,9,.667,0,4,4,7,0,1,3,4,41,29.5
29-320,2014-11-15,CLE,H,ATL,W,1,29,13,20,.650,9,15,.600,4,5,.800,2,4,.500,2,4,6,7,0,1,3,1,32,27.2
29-322,2014-11-17,CLE,H,DEN,L,1,41,8,18,.444,7,14,.500,1,4,.250,5,7,.714,0,9,9,5,0,2,4,2,22,14.6
29-324,2014-11-19,CLE,H,SAS,L,1,34,6,17,.353,4,14,.286,2,3,.667,1,1,1.000,3,3,6,9,1,1,5,3,15,10.3
29-326,2014-11-21,CLE,A,WAS,L,1,39,8,21,.381,6,14,.429,2,7,.286,4,7,.571,3,1,4,4,1,1,3,0,22,13.2
29-327,2014-11-22,CLE,H,TOR,L,1,37,6,12,.500,5,8,.625,1,4,.250,2,3,.667,0,1,1,10,1,1,5,2,15,11.8
29-329,2014-11-24,CLE,H,ORL,W,1,31,9,17,.529,7,13,.538,2,4,.500,9,11,.818,1,3,4,11,3,0,1,0,29,31.2
29-331,2014-11-26,CLE,H,WAS,W,1,36,7,14,.500,6,9,.667,1,5,.200,14,17,.824,1,9,10,8,3,0,4,3,29,27.6
29-334,2014-11-29,CLE,H,IND,W,1,32,9,18,.500,9,17,.529,0,1,.000,1,2,.500,0,2,2,7,1,0,3,1,19,12.7
29-337,2014-12-02,CLE,H,MIL,W,1,41,6,15,.400,6,11,.545,0,4,.000,14,21,.667,1,4,5,10,0,0,7,1,26,16.6
29-339,2014-12-04,CLE,A,NYK,W,1,40,7,17,.412,6,11,.545,1,6,.167,4,7,.571,1,4,5,12,2,0,4,2,19,16.2
29-340,2014-12-05,CLE,A,TOR,W,1,42,9,18,.500,7,14,.500,2,4,.500,4,6,.667,0,7,7,13,3,1,4,2,24,24.3
29-343,2014-12-08,CLE,A,BRK,W,1,34,8,17,.471,7,14,.500,1,3,.333,1,2,.500,0,4,4,7,3,0,3,2,18,14.2
29-344,2014-12-09,CLE,H,TOR,W,1,42,12,21,.571,10,16,.625,2,5,.400,9,9,1.000,1,1,2,4,2,2,2,1,35,29.9
29-347,2014-12-12,CLE,A,NOP,L,1,38,17,24,.708,15,22,.682,2,2,1.000,5,8,.625,0,5,5,5,0,1,2,1,41,33.1
29-350,2014-12-15,CLE,H,CHO,W,1,40,11,19,.579,9,16,.563,2,3,.667,3,4,.750,0,7,7,14,1,3,5,2,27,26.9
29-352,2014-12-17,CLE,H,ATL,L,1,29,8,16,.500,8,14,.571,0,2,.000,5,7,.714,0,3,3,2,2,0,2,0,21,14.5
29-354,2014-12-19,CLE,H,BRK,W,1,40,7,18,.389,5,14,.357,2,4,.500,6,8,.750,1,3,4,9,2,0,4,4,22,15.7
29-356,2014-12-21,CLE,H,MEM,W,1,38,9,15,.600,6,10,.600,3,5,.600,4,6,.667,0,1,1,11,0,1,5,1,25,20.6
29-358,2014-12-23,CLE,H,MIN,W,1,35,8,16,.500,4,9,.444,4,7,.571,4,5,.800,0,4,4,3,1,3,2,3,24,18.8
29-360,2014-12-25,CLE,A,MIA,L,1,40,9,16,.563,7,8,.875,2,8,.250,10,18,.556,0,4,4,8,0,0,4,1,30,21.6
29-361,2014-12-26,CLE,A,ORL,W,1,37,10,20,.500,10,15,.667,0,5,.000,9,11,.818,0,5,5,8,2,2,4,1,29,24.3
29-363,2014-12-28,CLE,H,DET,L,1,32,5,19,.263,3,13,.231,2,6,.333,5,5,1.000,1,9,10,7,1,0,7,3,17,6.8
30-014,2015-01-13,CLE,A,PHO,L,1,37,11,18,.611,8,10,.800,3,8,.375,8,13,.615,1,6,7,5,1,0,5,3,33,23.6
30-016,2015-01-15,CLE,A,LAL,W,1,38,12,23,.522,8,14,.571,4,9,.444,8,13,.615,1,3,4,5,2,0,1,2,36,28.0
30-017,2015-01-16,CLE,A,LAC,W,1,42,11,23,.478,8,15,.533,3,8,.375,7,12,.583,0,11,11,7,3,0,9,4,32,18.9
30-020,2015-01-19,CLE,H,CHI,W,1,36,12,23,.522,12,20,.600,0,3,.000,2,3,.667,1,4,5,4,0,0,6,4,26,11.4
30-022,2015-01-21,CLE,H,UTA,W,1,36,8,16,.500,8,14,.571,0,2,.000,10,14,.714,2,5,7,9,4,0,7,0,26,22.6
30-024,2015-01-23,CLE,H,CHO,W,1,27,9,15,.600,7,11,.636,2,4,.500,5,6,.833,1,5,6,9,4,1,2,1,25,28.5
30-026,2015-01-25,CLE,H,OKC,W,1,39,11,25,.440,9,19,.474,2,6,.333,10,13,.769,0,7,7,5,1,2,2,1,34,25.3
30-028,2015-01-27,CLE,A,DET,W,1,36,11,24,.458,11,20,.550,0,4,.000,10,11,.909,0,6,6,7,1,0,4,3,32,21.7
30-031,2015-01-30,CLE,H,SAC,W,1,33,7,16,.438,6,12,.500,1,4,.250,4,6,.667,0,3,3,7,4,2,6,1,19,14.6
30-032,2015-01-31,CLE,A,MIN,W,1,40,14,25,.560,11,17,.647,3,8,.375,5,8,.625,3,3,6,5,0,1,2,1,36,27.7
30-034,2015-02-02,CLE,H,PHI,W,1,36,6,17,.353,5,13,.385,1,4,.250,5,6,.833,0,3,3,11,2,0,6,2,18,11.9
30-037,2015-02-05,CLE,H,LAC,W,1,28,8,14,.571,7,12,.583,1,2,.500,6,7,.857,0,3,3,9,1,0,2,0,23,22.2
30-038,2015-02-06,CLE,A,IND,L,1,39,10,21,.476,10,17,.588,0,4,.000,5,8,.625,0,6,6,5,2,1,7,3,25,12.9
30-040,2015-02-08,CLE,H,LAL,W,1,30,8,16,.500,6,9,.667,2,7,.286,4,5,.800,2,8,10,8,1,0,6,2,22,17.2
30-043,2015-02-11,CLE,H,MIA,W,1,31,6,16,.375,6,12,.500,0,4,.000,6,7,.857,0,9,9,7,1,0,5,2,18,11.6
30-044,2015-02-12,CLE,A,CHI,L,1,34,12,26,.462,10,17,.588,2,9,.222,5,6,.833,0,5,5,4,0,0,8,3,31,12.3
30-052,2015-02-20,CLE,A,WAS,W,1,25,12,21,.571,9,16,.563,3,5,.600,1,3,.333,0,5,5,6,1,0,2,3,28,20.8
30-054,2015-02-22,CLE,A,NYK,W,1,28,7,17,.412,6,11,.545,1,6,.167,3,5,.600,0,7,7,7,2,0,4,2,18,12.3
30-056,2015-02-24,CLE,A,DET,W,1,39,6,14,.429,5,9,.556,1,5,.200,6,10,.600,0,7,7,11,3,1,9,3,19,13.3
30-058,2015-02-26,CLE,H,GSW,W,1,36,15,25,.600,11,16,.688,4,9,.444,8,11,.727,1,10,11,5,3,1,6,5,42,32.2
30-061,2015-03-01,CLE,A,HOU,L,1,42,15,35,.429,11,23,.478,4,12,.333,3,11,.273,2,6,8,4,3,3,4,4,37,20.8
30-063,2015-03-03,CLE,H,BOS,W,1,26,12,23,.522,12,22,.545,0,1,.000,3,3,1.000,1,2,3,5,3,1,1,0,27,23.2
30-064,2015-03-04,CLE,A,TOR,W,1,37,9,16,.563,6,10,.600,3,6,.500,8,13,.615,1,5,6,14,0,0,3,2,29,27.6
30-066,2015-03-06,CLE,A,ATL,L,1,40,5,13,.385,4,9,.444,1,4,.250,7,8,.875,1,5,6,8,2,1,9,3,18,10.8
30-067,2015-03-07,CLE,H,PHO,W,1,36,6,16,.375,4,11,.364,2,5,.400,3,6,.500,0,6,6,8,1,0,4,3,17,10.2
30-070,2015-03-10,CLE,A,DAL,W,1,29,10,14,.714,6,8,.750,4,6,.667,3,5,.600,0,7,7,8,1,1,2,3,27,26.6
30-072,2015-03-12,CLE,A,SAS,W,1,44,10,20,.500,7,14,.500,3,6,.500,8,10,.800,0,5,5,7,2,1,3,2,31,25.5
30-078,2015-03-18,CLE,H,BRK,W,1,35,5,13,.385,3,9,.333,2,4,.500,4,6,.667,1,2,3,7,1,0,2,1,16,12.9
30-080,2015-03-20,CLE,H,IND,W,1,39,13,26,.500,11,20,.550,2,6,.333,1,2,.500,0,7,7,5,0,0,3,0,29,18.2
30-082,2015-03-22,CLE,A,MIL,W,1,39,10,17,.588,9,13,.692,1,4,.250,7,7,1.000,2,8,10,6,5,1,5,1,28,28.4
30-085,2015-03-25,CLE,A,MEM,W,1,31,7,15,.467,4,10,.400,3,5,.600,3,4,.750,0,8,8,5,0,0,1,2,20,16.0
30-087,2015-03-27,CLE,A,BRK,L,1,38,8,15,.533,6,10,.600,2,5,.400,6,8,.750,0,5,5,9,5,1,3,4,24,24.8
30-089,2015-03-29,CLE,H,PHI,W,1,38,8,24,.333,7,20,.350,1,4,.250,3,6,.500,2,9,11,6,0,1,5,0,20,9.2
30-093,2015-04-02,CLE,H,MIA,W,1,35,9,16,.563,8,14,.571,1,2,.500,4,5,.800,1,7,8,7,1,3,3,3,23,21.6
30-096,2015-04-05,CLE,H,CHI,W,1,37,8,17,.471,7,14,.500,1,3,.333,3,6,.500,2,8,10,12,3,1,3,4,20,21.4
30-099,2015-04-08,CLE,A,MIL,W,1,40,8,15,.533,6,10,.600,2,5,.400,3,4,.750,2,7,9,8,1,1,2,2,21,21.3
30-101,2015-04-10,CLE,H,BOS,L,1,26,5,14,.357,5,9,.556,0,5,.000,4,9,.444,0,3,3,7,1,0,3,1,14,7.6
30-104,2015-04-13,CLE,H,DET,W,1,32,7,17,.412,4,13,.308,3,4,.750,4,6,.667,3,7,10,11,2,1,1,0,21,24.7
30-301,2015-10-27,CLE,A,CHI,L,1,36,12,22,.545,11,17,.647,1,5,.200,0,3,.000,0,10,10,5,1,0,1,3,25,18.5
30-302,2015-10-28,CLE,A,MEM,W,1,31,4,13,.308,4,10,.400,0,3,.000,4,8,.500,1,6,7,5,3,0,3,1,12,8.5
30-304,2015-10-30,CLE,H,MIA,W,1,34,13,19,.684,13,17,.765,0,2,.000,3,5,.600,2,3,5,4,1,0,4,3,29,21.0
30-307,2015-11-02,CLE,A,PHI,W,1,33,9,19,.474,9,16,.563,0,3,.000,4,4,1.000,0,9,9,11,4,2,3,3,22,23.9
30-309,2015-11-04,CLE,H,NYK,W,1,35,9,23,.391,8,18,.444,1,5,.200,4,7,.571,2,3,5,3,4,1,3,1,23,15.0
30-311,2015-11-06,CLE,H,PHI,W,1,36,12,22,.545,9,17,.529,3,5,.600,4,6,.667,0,4,4,13,2,0,2,1,31,29.5
30-313,2015-11-08,CLE,H,IND,W,1,35,10,23,.435,10,20,.500,0,3,.000,9,14,.643,0,6,6,4,0,0,2,0,29,17.5
30-315,2015-11-10,CLE,H,UTA,W,1,38,11,19,.579,10,16,.625,1,3,.333,8,12,.667,3,4,7,8,2,0,5,2,31,25.6
30-318,2015-11-13,CLE,A,NYK,W,1,39,12,21,.571,12,19,.632,0,2,.000,7,10,.700,0,3,3,6,2,1,3,4,31,23.1
30-319,2015-11-14,CLE,A,MIL,L,1,45,13,27,.481,8,16,.500,5,11,.455,6,12,.500,4,8,12,5,1,3,7,3,37,24.5
30-322,2015-11-17,CLE,A,DET,L,1,40,11,21,.524,7,14,.500,4,7,.571,4,5,.800,0,6,6,3,0,0,4,3,30,18.0
30-324,2015-11-19,CLE,H,MIL,W,1,35,9,13,.692,8,12,.667,1,1,1.000,8,9,.889,3,6,9,6,0,0,4,3,27,24.0
30-326,2015-11-21,CLE,H,ATL,W,1,33,8,15,.533,7,13,.538,1,2,.500,2,2,1.000,2,9,11,8,0,2,3,1,19,19.4
30-328,2015-11-23,CLE,H,ORL,W,1,35,7,14,.500,7,12,.583,0,2,.000,1,5,.200,0,6,6,13,1,0,2,0,15,16.3
30-330,2015-11-25,CLE,A,TOR,L,1,40,6,16,.375,5,11,.455,1,5,.200,11,12,.917,2,4,6,8,0,0,2,1,24,20.6
30-332,2015-11-27,CLE,A,CHO,W,1,38,8,20,.400,6,15,.400,2,5,.400,7,9,.778,2,11,13,5,0,0,3,2,25,17.8
30-333,2015-11-28,CLE,H,BRK,W,1,36,10,22,.455,9,16,.563,1,6,.167,5,6,.833,2,7,9,5,1,0,2,0,26,20.2
30-336,2015-12-01,CLE,H,WAS,L,1,37,8,20,.400,8,17,.471,0,3,.000,8,8,1.000,4,9,13,4,1,1,9,3,24,13.0
30-339,2015-12-04,CLE,A,NOP,L,1,45,13,29,.448,12,24,.500,1,5,.200,10,11,.909,2,5,7,8,1,1,5,4,37,25.1
30-343,2015-12-08,CLE,H,POR,W,1,40,14,24,.583,13,21,.619,1,3,.333,4,4,1.000,1,9,10,3,2,3,2,3,33,28.2
30-346,2015-12-11,CLE,A,ORL,W,1,29,10,15,.667,10,14,.714,0,1,.000,5,8,.625,0,3,3,8,4,0,4,0,25,23.8
30-350,2015-12-15,CLE,A,BOS,W,1,36,10,20,.500,10,17,.588,0,3,.000,4,4,1.000,1,6,7,3,2,1,6,3,24,14.1
30-352,2015-12-17,CLE,H,OKC,W,1,40,12,27,.444,10,22,.455,2,5,.400,7,8,.875,2,7,9,11,2,0,7,2,33,23.9
30-355,2015-12-20,CLE,H,PHI,W,1,25,10,17,.588,10,14,.714,0,3,.000,3,4,.750,0,5,5,4,3,1,2,0,23,20.7
30-358,2015-12-23,CLE,H,NYK,W,1,38,9,22,.409,9,19,.474,0,3,.000,6,7,.857,1,8,9,5,0,0,1,2,24,16.6
30-360,2015-12-25,CLE,A,GSW,L,1,39,10,26,.385,9,21,.429,1,5,.200,4,9,.444,2,7,9,2,1,2,4,0,25,12.1
30-361,2015-12-26,CLE,A,POR,L,1,26,4,13,.308,4,10,.400,0,3,.000,4,5,.800,0,4,4,5,0,0,3,2,12,5.0
30-363,2015-12-28,CLE,A,PHO,W,1,35,4,10,.400,3,5,.600,1,5,.200,5,9,.556,0,4,4,7,2,1,2,3,14,12.6
30-364,2015-12-29,CLE,A,DEN,W,1,34,13,24,.542,12,21,.571,1,3,.333,7,8,.875,3,3,6,2,2,1,5,2,34,23.3
31-003,2016-01-02,CLE,H,ORL,W,1,29,11,18,.611,7,11,.636,4,7,.571,3,4,.750,0,5,5,3,2,0,0,2,29,25.2
31-005,2016-01-04,CLE,H,TOR,W,1,31,7,11,.636,6,9,.667,1,2,.500,5,8,.625,0,2,2,7,3,0,2,1,20,20.0
31-007,2016-01-06,CLE,A,WAS,W,1,40,12,22,.545,8,13,.615,4,9,.444,6,8,.750,0,10,10,4,1,1,2,3,34,26.9
31-009,2016-01-08,CLE,A,MIN,W,1,32,5,12,.417,5,8,.625,0,4,.000,3,4,.750,0,12,12,8,1,2,3,1,13,14.4
31-011,2016-01-10,CLE,A,PHI,W,1,37,15,22,.682,12,17,.706,3,5,.600,4,6,.667,0,7,7,9,2,0,2,1,37,34.8
31-013,2016-01-12,CLE,A,DAL,W,1,42,9,17,.529,6,11,.545,3,6,.500,6,8,.750,3,7,10,7,2,0,4,2,27,24.2
31-015,2016-01-14,CLE,A,SAS,L,1,37,9,17,.529,8,14,.571,1,3,.333,3,4,.750,2,5,7,5,0,0,4,4,22,14.1
31-016,2016-01-15,CLE,A,HOU,W,1,36,7,14,.500,6,12,.500,1,2,.500,4,6,.667,2,5,7,7,0,2,4,1,19,16.0
31-019,2016-01-18,CLE,H,GSW,L,1,33,7,16,.438,7,13,.538,0,3,.000,2,2,1.000,1,4,5,5,1,1,3,1,16,11.3
31-021,2016-01-20,CLE,A,BRK,W,1,29,7,12,.583,6,11,.545,1,1,1.000,2,4,.500,0,1,1,5,1,1,4,1,17,11.7
31-022,2016-01-21,CLE,H,LAC,W,1,35,9,17,.529,8,13,.615,1,4,.250,3,5,.600,1,4,5,12,0,0,0,4,22,21.6
31-024,2016-01-23,CLE,H,CHI,L,1,40,11,27,.407,11,22,.500,0,5,.000,4,7,.571,3,10,13,9,2,1,1,3,26,22.2
31-026,2016-01-25,CLE,H,MIN,W,1,38,11,15,.733,10,14,.714,1,1,1.000,2,3,.667,0,4,4,9,1,1,5,2,25,21.9
31-028,2016-01-27,CLE,H,PHO,W,1,31,7,8,.875,7,7,1.000,0,1,.000,7,7,1.000,0,3,3,9,0,0,2,2,21,22.6
31-030,2016-01-29,CLE,A,DET,W,1,36,7,16,.438,7,14,.500,0,2,.000,6,7,.857,1,8,9,8,1,0,1,3,20,18.7
31-031,2016-01-30,CLE,H,SAS,W,1,34,10,17,.588,10,15,.667,0,2,.000,9,11,.818,1,4,5,7,2,2,2,2,29,27.7
31-033,2016-02-01,CLE,A,IND,W,1,44,9,22,.409,9,17,.529,0,5,.000,6,10,.600,2,10,12,6,2,1,1,2,24,20.1
31-035,2016-02-03,CLE,A,CHO,L,1,39,10,21,.476,10,18,.556,0,3,.000,3,5,.600,0,6,6,6,1,2,1,1,23,18.5
31-037,2016-02-05,CLE,H,BOS,L,1,38,9,23,.391,9,18,.500,0,5,.000,12,17,.706,3,4,7,4,2,1,6,2,30,17.5
31-038,2016-02-06,CLE,H,NOP,W,1,37,11,20,.550,9,15,.600,2,5,.400,3,3,1.000,0,3,3,8,1,0,2,2,27,22.1
31-040,2016-02-08,CLE,H,SAC,W,1,31,8,16,.500,7,14,.500,1,2,.500,4,5,.800,1,9,10,10,2,1,4,1,21,21.3
31-042,2016-02-10,CLE,H,LAL,W,1,37,12,22,.545,9,16,.563,3,6,.500,2,5,.400,1,6,7,11,1,0,1,1,29,27.0
31-050,2016-02-18,CLE,H,CHI,W,1,35,11,19,.579,11,17,.647,0,2,.000,3,3,1.000,2,7,9,9,0,1,2,3,25,23.4
31-053,2016-02-21,CLE,A,OKC,W,1,38,11,22,.500,9,17,.529,2,5,.400,1,1,1.000,3,4,7,11,3,0,5,3,25,21.8
31-054,2016-02-22,CLE,H,DET,L,1,38,5,18,.278,5,14,.357,0,4,.000,2,2,1.000,1,7,8,5,3,0,6,2,12,3.9
31-056,2016-02-24,CLE,H,CHO,W,1,30,8,13,.615,6,9,.667,2,4,.500,5,8,.625,1,6,7,7,2,0,2,1,23,22.9
31-058,2016-02-26,CLE,A,TOR,L,1,40,9,18,.500,7,14,.500,2,4,.500,5,9,.556,1,7,8,7,1,0,6,2,25,16.3
31-061,2016-02-29,CLE,H,IND,W,1,37,14,22,.636,12,18,.667,2,4,.500,3,5,.600,0,5,5,4,2,0,5,2,33,22.9
31-065,2016-03-04,CLE,H,WAS,W,1,30,7,18,.389,6,14,.429,1,4,.250,4,4,1.000,1,12,13,8,3,0,1,1,19,20.7
31-066,2016-03-05,CLE,H,BOS,W,1,36,11,20,.550,10,16,.625,1,4,.250,5,9,.556,4,7,11,8,2,1,4,2,28,25.2
31-068,2016-03-07,CLE,H,MEM,L,1,38,11,19,.579,9,15,.600,2,4,.500,4,5,.800,2,7,9,5,1,0,4,2,28,21.9
31-070,2016-03-09,CLE,A,SAC,W,1,37,8,19,.421,7,14,.500,1,5,.200,8,9,.889,4,7,11,6,0,0,5,1,25,18.2
31-071,2016-03-10,CLE,A,LAL,W,1,35,9,18,.500,8,14,.571,1,4,.250,5,8,.625,2,3,5,7,0,2,3,2,24,18.6
31-074,2016-03-13,CLE,A,LAC,W,1,31,9,15,.600,6,11,.545,3,4,.750,6,7,.857,1,5,6,5,1,0,2,2,27,23.6
31-075,2016-03-14,CLE,A,UTA,L,1,37,10,20,.500,8,14,.571,2,6,.333,1,2,.500,6,6,12,3,1,0,3,0,23,18.7
31-079,2016-03-18,CLE,A,ORL,W,1,36,6,15,.400,6,12,.500,0,3,.000,6,6,1.000,1,6,7,8,1,1,4,3,18,14.5
31-080,2016-03-19,CLE,A,MIA,L,1,27,13,20,.650,13,17,.765,0,3,.000,0,0,,0,3,3,3,1,0,3,1,26,17.8
31-082,2016-03-21,CLE,H,DEN,W,1,33,12,19,.632,11,17,.647,1,2,.500,8,11,.727,3,8,11,11,0,0,3,2,33,31.7
31-084,2016-03-23,CLE,H,MIL,W,1,37,9,22,.409,8,18,.444,1,4,.250,7,10,.700,5,1,6,8,2,1,2,0,26,23.1
31-085,2016-03-24,CLE,A,BRK,L,1,35,13,16,.813,12,14,.857,1,2,.500,3,4,.750,1,5,6,5,1,0,4,2,30,25.5
31-087,2016-03-26,CLE,A,NYK,W,1,36,10,21,.476,8,18,.444,2,3,.667,5,6,.833,3,8,11,11,1,2,2,4,27,26.9
31-092,2016-03-31,CLE,H,BRK,W,1,31,8,11,.727,8,11,.727,0,0,,8,10,.800,0,4,4,11,2,1,6,0,24,24.3
31-093,2016-04-01,CLE,A,ATL,W,1,44,12,26,.462,11,21,.524,1,5,.200,4,5,.800,3,13,16,9,3,1,3,4,29,26.6
31-095,2016-04-03,CLE,H,CHO,W,1,41,14,22,.636,14,22,.636,0,0,,3,3,1.000,3,5,8,12,2,0,5,4,31,28.6
31-097,2016-04-05,CLE,A,MIL,W,1,28,7,9,.778,6,7,.857,1,2,.500,2,2,1.000,0,5,5,9,0,1,4,0,17,18.0
31-101,2016-04-09,CLE,A,CHI,L,1,39,13,17,.765,9,12,.750,4,5,.800,3,4,.750,3,4,7,3,0,1,4,1,33,27.6
31-103,2016-04-11,CLE,H,ATL,W,1,32,13,16,.813,10,12,.833,3,4,.750,5,5,1.000,1,5,6,6,2,1,4,2,34,32.3
31-300,2016-10-25,CLE,H,NYK,W,1,32,9,14,.643,9,11,.818,0,3,.000,1,2,.500,3,8,11,14,0,1,4,3,19,22.2
31-303,2016-10-28,CLE,A,TOR,W,1,39,7,16,.438,5,10,.500,2,6,.333,5,7,.714,2,6,8,7,0,0,5,2,21,14.1
31-304,2016-10-29,CLE,H,ORL,W,1,39,7,16,.438,5,10,.500,2,6,.333,7,11,.636,1,5,6,9,1,1,2,2,23,20.4
31-307,2016-11-01,CLE,H,HOU,W,1,36,6,12,.500,5,9,.556,1,3,.333,6,10,.600,3,10,13,8,0,0,4,4,19,16.5
31-309,2016-11-03,CLE,H,BOS,W,1,36,12,22,.545,11,18,.611,1,4,.250,5,5,1.000,1,6,7,12,1,0,2,2,30,28.5
31-311,2016-11-05,CLE,A,PHI,W,1,36,9,23,.391,8,18,.444,1,5,.200,6,7,.857,1,7,8,14,2,1,5,1,25,22.0
31-314,2016-11-08,CLE,H,ATL,L,1,37,8,17,.471,6,12,.500,2,5,.400,5,5,1.000,2,7,9,5,3,0,1,3,23,22.1
31-317,2016-11-11,CLE,A,WAS,W,1,38,9,18,.500,6,14,.429,3,4,.750,6,9,.667,0,10,10,5,2,2,6,1,27,20.3
31-319,2016-11-13,CLE,H,CHO,W,1,39,8,21,.381,6,16,.375,2,5,.400,1,2,.500,0,8,8,8,1,1,3,0,19,13.8
31-321,2016-11-15,CLE,H,TOR,W,1,38,10,15,.667,8,10,.800,2,5,.400,6,10,.600,0,9,9,15,1,0,5,2,28,28.3
31-333,2016-11-27,CLE,A,PHI,W,1,42,9,19,.474,8,15,.533,1,4,.250,7,9,.778,2,8,10,13,1,0,5,0,26,24.4
31-335,2016-11-29,CLE,A,MIL,L,1,33,8,16,.500,5,8,.625,3,8,.375,3,7,.429,0,4,4,4,0,0,7,3,22,8.2
31-337,2016-12-01,CLE,H,LAC,L,1,34,5,14,.357,5,12,.417,0,2,.000,6,11,.545,1,4,5,5,2,0,5,2,16,7.8
31-338,2016-12-02,CLE,A,CHI,L,1,45,13,22,.591,12,19,.632,1,3,.333,0,0,,0,5,5,13,0,0,8,2,27,18.6
31-341,2016-12-05,CLE,A,TOR,W,1,42,12,26,.462,10,19,.526,2,7,.286,8,9,.889,3,5,8,7,2,0,1,2,34,28.9
31-343,2016-12-07,CLE,A,NYK,W,1,32,7,10,.700,6,8,.750,1,2,.500,10,14,.714,2,4,6,7,1,2,4,2,25,24.3
31-345,2016-12-09,CLE,H,MIA,W,1,37,12,22,.545,11,19,.579,1,3,.333,2,4,.500,2,6,8,8,3,0,3,2,27,23.6
31-346,2016-12-10,CLE,H,CHO,W,1,42,17,24,.708,12,14,.857,5,10,.500,5,9,.556,1,8,9,10,3,1,5,3,44,40.0
31-349,2016-12-13,CLE,H,MEM,W,1,36,9,17,.529,9,13,.692,0,4,.000,5,8,.625,1,5,6,8,3,0,6,1,23,17.9
31-353,2016-12-17,CLE,H,LAL,W,1,39,9,18,.500,7,13,.538,2,5,.400,6,11,.545,1,6,7,9,2,2,2,1,26,24.8
31-356,2016-12-20,CLE,A,MIL,W,1,47,12,25,.480,7,16,.438,5,9,.556,5,6,.833,3,9,12,7,1,1,2,2,34,29.5
31-357,2016-12-21,CLE,H,MIL,W,1,34,12,24,.500,8,17,.471,4,7,.571,1,1,1.000,1,8,9,6,0,0,2,0,29,22.3
31-359,2016-12-23,CLE,H,BRK,W,1,27,7,16,.438,7,13,.538,0,3,.000,5,6,.833,1,3,4,6,3,0,1,0,19,18.0
31-361,2016-12-25,CLE,H,GSW,W,1,40,12,22,.545,8,14,.571,4,8,.500,3,7,.429,5,8,13,4,2,1,5,2,31,24.4
31-365,2016-12-29,CLE,H,BOS,W,1,44,9,18,.500,7,12,.583,2,6,.333,3,7,.429,2,6,8,11,1,3,8,2,23,17.6
32-001,2016-12-31,CLE,A,CHO,W,1,36,12,25,.480,8,17,.471,4,8,.500,4,6,.667,2,4,6,9,1,0,1,1,32,27.0
32-003,2017-01-02,CLE,H,NOP,W,1,39,9,21,.429,9,17,.529,0,4,.000,8,10,.800,2,5,7,6,2,1,4,1,26,19.5
32-005,2017-01-04,CLE,H,CHI,L,1,37,12,21,.571,11,19,.579,1,2,.500,6,9,.667,2,6,8,7,1,0,5,2,31,23.2
32-007,2017-01-06,CLE,A,BRK,W,1,35,14,20,.700,14,19,.737,0,1,.000,8,10,.800,0,9,9,6,3,0,5,2,36,30.9
32-009,2017-01-08,CLE,A,PHO,W,1,40,11,17,.647,9,13,.692,2,4,.500,4,6,.667,3,5,8,4,1,0,7,3,28,18.9
32-011,2017-01-10,CLE,A,UTA,L,1,37,10,20,.500,7,14,.500,3,6,.500,6,7,.857,1,5,6,5,4,0,4,0,29,24.3
32-012,2017-01-11,CLE,A,POR,L,1,31,5,12,.417,3,7,.429,2,5,.400,8,9,.889,1,10,11,4,1,1,5,1,20,16.0
32-014,2017-01-13,CLE,A,SAC,W,1,42,6,12,.500,5,8,.625,1,4,.250,3,3,1.000,0,2,2,15,1,1,5,2,16,17.0
32-017,2017-01-16,CLE,A,GSW,L,1,35,6,18,.333,5,14,.357,1,4,.250,7,10,.700,2,6,8,2,1,0,6,1,20,7.8
32-020,2017-01-19,CLE,H,PHO,W,1,39,8,12,.667,8,10,.800,0,2,.000,5,8,.625,0,9,9,15,1,2,4,2,21,25.4
32-022,2017-01-21,CLE,H,SAS,L,1,45,11,16,.688,9,11,.818,2,5,.400,5,7,.714,0,6,6,7,2,0,7,5,29,21.1
32-024,2017-01-23,CLE,A,NOP,L,1,44,11,21,.524,10,17,.588,1,4,.250,3,4,.750,2,8,10,12,2,0,6,2,26,22.7
32-026,2017-01-25,CLE,H,SAC,L,1,45,8,15,.533,8,12,.667,0,3,.000,8,11,.727,4,9,13,11,2,1,5,3,24,25.2
32-028,2017-01-27,CLE,H,BRK,W,1,34,13,18,.722,12,15,.800,1,3,.333,4,7,.571,0,5,5,11,0,0,5,1,31,26.2
32-030,2017-01-29,CLE,H,OKC,W,1,37,9,18,.500,9,16,.563,0,2,.000,7,10,.700,1,13,14,8,1,0,2,1,25,23.6
32-031,2017-01-30,CLE,A,DAL,L,1,37,9,19,.474,8,13,.615,1,6,.167,4,8,.500,0,9,9,9,2,0,5,0,23,17.7
32-033,2017-02-01,CLE,H,MIN,W,1,34,11,14,.786,10,12,.833,1,2,.500,4,7,.571,0,8,8,12,2,1,2,1,27,31.5
32-036,2017-02-04,CLE,A,NYK,W,1,40,12,20,.600,8,12,.667,4,8,.500,4,5,.800,0,5,5,10,0,0,5,1,32,25.5
32-038,2017-02-06,CLE,A,WAS,W,1,42,12,18,.667,6,10,.600,6,8,.750,2,5,.400,0,7,7,17,2,2,6,6,32,32.0
32-040,2017-02-08,CLE,A,IND,W,1,38,9,16,.563,8,14,.571,1,2,.500,6,8,.750,1,5,6,9,1,1,4,2,25,22.0
32-041,2017-02-09,CLE,A,OKC,L,1,41,8,19,.421,7,15,.467,1,4,.250,1,3,.333,1,4,5,7,2,2,3,1,18,13.9
32-043,2017-02-11,CLE,H,DEN,W,1,33,11,16,.688,10,15,.667,1,1,1.000,4,4,1.000,0,5,5,12,2,0,6,1,27,25.7
32-046,2017-02-14,CLE,A,MIN,W,1,40,10,14,.714,8,11,.727,2,3,.667,3,6,.500,1,7,8,14,0,0,6,3,25,23.4
32-047,2017-02-15,CLE,H,IND,W,1,33,12,17,.706,8,12,.667,4,5,.800,3,4,.750,0,5,5,4,1,0,4,2,31,24.0
32-055,2017-02-23,CLE,H,NYK,W,1,37,7,11,.636,7,9,.778,0,2,.000,4,6,.667,0,13,13,15,0,3,6,1,18,22.4
32-059,2017-02-27,CLE,H,MIL,W,1,37,8,12,.667,7,10,.700,1,2,.500,7,9,.778,0,10,10,6,0,0,3,1,24,21.8
32-061,2017-03-01,CLE,A,BOS,L,1,40,10,21,.476,7,15,.467,3,6,.500,5,8,.625,5,8,13,10,1,1,4,3,28,25.5
32-063,2017-03-03,CLE,A,ATL,W,1,39,14,27,.519,8,17,.471,6,10,.600,4,8,.500,1,12,13,8,0,0,2,4,38,29.4
32-066,2017-03-06,CLE,H,MIA,L,1,39,11,22,.500,9,17,.529,2,5,.400,6,10,.600,3,14,17,6,1,1,3,2,30,25.8
32-069,2017-03-09,CLE,A,DET,L,1,39,12,22,.545,12,16,.750,0,6,.000,5,8,.625,4,10,14,10,1,0,3,1,29,27.6
32-071,2017-03-11,CLE,A,ORL,W,1,38,8,14,.571,6,9,.667,2,5,.400,6,10,.600,0,12,12,12,0,1,4,3,24,23.3
32-072,2017-03-12,CLE,A,HOU,L,1,40,12,20,.600,8,9,.889,4,11,.364,2,3,.667,0,7,7,5,2,0,8,2,30,19.2
32-074,2017-03-14,CLE,H,DET,W,1,28,6,12,.500,6,10,.600,0,2,.000,4,5,.800,0,11,11,12,0,0,2,0,16,19.3
32-076,2017-03-16,CLE,H,UTA,W,1,38,13,20,.650,11,15,.733,2,5,.400,5,10,.500,0,10,10,6,2,1,6,0,33,26.1
32-079,2017-03-19,CLE,A,LAL,W,1,38,13,22,.591,10,14,.714,3,8,.375,5,8,.625,0,6,6,7,1,0,3,2,34,26.5
32-082,2017-03-22,CLE,A,DEN,L,1,34,8,12,.667,8,10,.800,0,2,.000,2,4,.500,2,4,6,5,0,0,4,1,18,13.7
32-084,2017-03-24,CLE,A,CHO,W,1,40,9,14,.643,9,13,.692,0,1,.000,14,16,.875,0,9,9,11,1,2,4,2,32,33.0
32-085,2017-03-25,CLE,H,WAS,L,1,41,10,21,.476,10,17,.588,0,4,.000,4,6,.667,3,8,11,8,0,1,3,2,24,19.5
32-087,2017-03-27,CLE,A,SAS,L,1,30,7,17,.412,7,14,.500,0,3,.000,3,6,.500,3,5,8,8,0,0,2,3,17,12.7
32-090,2017-03-30,CLE,A,CHI,L,1,39,11,20,.550,10,13,.769,1,7,.143,3,7,.429,1,9,10,8,1,1,4,0,26,21.5
32-091,2017-03-31,CLE,H,PHI,W,1,30,14,22,.636,11,15,.733,3,7,.429,3,6,.500,2,7,9,6,0,0,2,2,34,27.9
32-093,2017-04-02,CLE,H,IND,W,1,52,16,29,.552,13,19,.684,3,10,.300,6,12,.500,4,10,14,11,2,1,1,4,41,38.3
32-095,2017-04-04,CLE,H,ORL,W,1,37,7,14,.500,7,11,.636,0,3,.000,4,6,.667,1,10,11,11,2,1,6,2,18,17.5
32-096,2017-04-05,CLE,A,BOS,W,1,39,14,22,.636,13,18,.722,1,4,.250,7,7,1.000,2,8,10,6,1,2,3,3,36,32.4
32-098,2017-04-07,CLE,H,ATL,L,1,41,12,15,.800,11,13,.846,1,2,.500,2,6,.333,1,7,8,7,2,0,5,0,27,24.4
32-100,2017-04-09,CLE,A,ATL,L,1,47,11,21,.524,10,18,.556,1,3,.333,9,10,.900,3,13,16,10,1,0,3,6,32,29.9
32-291,2017-10-17,CLE,H,BOS,W,1,41,12,19,.632,11,14,.786,1,5,.200,4,4,1.000,1,15,16,9,0,2,4,3,29,28.2
32-294,2017-10-20,CLE,A,MIL,W,1,37,10,16,.625,8,12,.667,2,4,.500,2,2,1.000,1,4,5,8,1,1,5,2,24,20.2
32-295,2017-10-21,CLE,H,ORL,L,1,31,8,15,.533,7,12,.583,1,3,.333,5,6,.833,0,4,4,2,1,1,1,0,22,17.6
32-298,2017-10-24,CLE,H,CHI,W,1,37,13,20,.650,9,14,.643,4,6,.667,4,5,.800,0,2,2,13,3,0,2,1,34,35.1
32-299,2017-10-25,CLE,A,BRK,L,1,41,12,20,.600,11,18,.611,1,2,.500,4,8,.500,1,9,10,13,0,4,8,1,29,25.1
32-302,2017-10-28,CLE,A,NOP,L,1,31,6,11,.545,5,8,.625,1,3,.333,5,6,.833,0,3,3,8,0,0,4,3,18,13.6
32-303,2017-10-29,CLE,H,NYK,L,1,39,7,15,.467,6,11,.545,1,4,.250,1,1,1.000,1,9,10,7,2,0,4,2,16,13.8
32-306,2017-11-01,CLE,H,IND,L,1,37,14,22,.636,13,17,.765,1,5,.200,4,5,.800,1,5,6,11,2,1,8,1,33,27.0
32-308,2017-11-03,CLE,A,WAS,W,1,43,23,34,.676,21,30,.700,2,4,.500,9,9,1.000,5,6,11,7,3,2,3,2,57,53.2
32-310,2017-11-05,CLE,H,ATL,L,1,41,10,17,.588,10,14,.714,0,3,.000,6,6,1.000,2,3,5,13,1,2,6,4,26,24.3
32-312,2017-11-07,CLE,H,MIL,W,1,37,10,20,.500,8,16,.500,2,4,.500,8,10,.800,1,7,8,9,3,0,1,1,30,29.9
32-314,2017-11-09,CLE,A,HOU,L,1,40,15,24,.625,14,20,.700,1,4,.250,2,3,.667,0,4,4,7,1,1,8,4,33,20.0
32-316,2017-11-11,CLE,A,DAL,W,1,42,6,14,.429,5,11,.455,1,3,.333,6,8,.750,1,10,11,4,0,1,6,3,19,10.8
32-318,2017-11-13,CLE,A,NYK,W,1,36,7,14,.500,5,10,.500,2,4,.500,7,10,.700,3,6,9,12,0,3,5,1,23,23.8
32-320,2017-11-15,CLE,A,CHO,W,1,37,12,24,.500,8,17,.471,4,7,.571,3,3,1.000,2,4,6,8,2,1,3,4,31,25.3
32-322,2017-11-17,CLE,H,LAC,W,1,46,17,26,.654,13,17,.765,4,9,.444,1,5,.200,1,13,14,6,0,0,6,0,39,28.8
32-325,2017-11-20,CLE,A,DET,W,1,27,7,14,.500,4,9,.444,3,5,.600,1,1,1.000,0,2,2,8,1,1,0,2,18,18.1
32-327,2017-11-22,CLE,H,BRK,W,1,33,11,17,.647,7,10,.700,4,7,.571,7,9,.778,1,5,6,5,2,0,3,2,33,28.6
32-329,2017-11-24,CLE,H,CHO,W,1,40,10,20,.500,7,12,.583,3,8,.375,4,7,.571,1,15,16,13,0,3,3,2,27,28.4
32-332,2017-11-27,CLE,A,PHI,W,1,31,12,23,.522,9,16,.563,3,7,.429,3,4,.750,3,11,14,6,0,0,3,0,30,24.9
32-333,2017-11-28,CLE,H,MIA,W,1,28,10,16,.625,9,13,.692,1,3,.333,0,1,.000,2,10,12,6,5,1,2,1,21,25.3
32-335,2017-11-30,CLE,A,ATL,W,1,38,8,11,.727,5,5,1.000,3,6,.500,5,7,.714,1,5,6,12,2,2,3,3,24,28.5
32-337,2017-12-02,CLE,H,MEM,W,1,39,13,22,.591,13,19,.684,0,3,.000,8,8,1.000,0,2,2,12,0,1,5,1,34,28.1
32-339,2017-12-04,CLE,A,CHI,W,1,34,9,15,.600,7,11,.636,2,4,.500,3,4,.750,0,7,7,6,2,0,2,1,23,21.6
32-341,2017-12-06,CLE,H,SAC,W,1,41,12,18,.667,7,10,.700,5,8,.625,3,6,.500,2,9,11,9,3,2,7,0,32,30.8
32-343,2017-12-08,CLE,A,IND,L,1,39,12,22,.545,11,17,.647,1,5,.200,4,5,.800,2,8,10,8,1,2,3,1,29,26.4
32-344,2017-12-09,CLE,H,PHI,W,1,39,9,23,.391,7,17,.412,2,6,.333,10,12,.833,3,10,13,13,3,0,6,1,30,27.5
32-347,2017-12-12,CLE,H,ATL,W,1,35,11,13,.846,9,10,.900,2,3,.667,1,2,.500,0,7,7,17,2,0,2,4,25,32.3
32-349,2017-12-14,CLE,H,LAL,W,1,39,8,18,.444,7,12,.583,1,6,.167,8,12,.667,1,11,12,12,2,2,5,0,25,24.8
32-351,2017-12-16,CLE,H,UTA,W,1,37,9,15,.600,8,11,.727,1,4,.250,10,10,1.000,0,11,11,10,1,0,5,2,29,27.6
32-352,2017-12-17,CLE,A,WAS,W,1,41,8,23,.348,6,16,.375,2,7,.286,2,3,.667,2,9,11,15,0,1,6,4,20,14.4
32-354,2017-12-19,CLE,A,MIL,L,1,34,14,22,.636,8,11,.727,6,11,.545,5,5,1.000,0,1,1,7,3,2,7,1,39,31.4
32-356,2017-12-21,CLE,H,CHI,W,1,39,12,23,.522,10,18,.556,2,5,.400,8,8,1.000,1,5,6,9,3,0,4,1,34,29.8
32-360,2017-12-25,CLE,A,GSW,L,1,40,7,18,.389,5,11,.455,2,7,.286,4,7,.571,1,5,6,6,0,0,7,2,20,7.6
32-362,2017-12-27,CLE,A,SAC,L,1,38,6,17,.353,6,15,.400,0,2,.000,4,5,.800,2,8,10,14,5,0,4,2,16,19.9
33-000,2017-12-30,CLE,A,UTA,L,1,37,12,22,.545,11,15,.733,1,7,.143,4,5,.800,1,7,8,6,2,1,6,1,29,21.3
33-003,2018-01-02,CLE,H,POR,W,1,34,10,17,.588,10,15,.667,0,2,.000,4,4,1.000,1,5,6,8,4,1,3,2,24,24.8
33-009,2018-01-08,CLE,A,MIN,L,1,27,4,8,.500,3,5,.600,1,3,.333,1,3,.333,1,7,8,5,0,2,3,2,10,9.1
33-012,2018-01-11,CLE,A,TOR,L,1,32,9,16,.563,9,15,.600,0,1,.000,8,10,.800,0,3,3,1,1,2,2,1,26,19.2
33-013,2018-01-12,CLE,A,IND,L,1,40,11,25,.440,9,16,.563,2,9,.222,3,4,.750,2,6,8,11,3,1,5,2,27,22.3
33-016,2018-01-15,CLE,H,GSW,L,1,36,12,18,.667,12,16,.750,0,2,.000,8,13,.615,2,6,8,6,3,4,8,3,32,26.2
33-019,2018-01-18,CLE,H,ORL,W,1,35,7,16,.438,7,12,.583,0,4,.000,2,8,.250,1,4,5,6,1,0,6,1,16,5.9
33-021,2018-01-20,CLE,H,OKC,L,1,38,8,17,.471,8,13,.615,0,4,.000,2,4,.500,0,3,3,7,0,1,2,2,18,12.2
33-024,2018-01-23,CLE,A,SAS,L,1,38,10,23,.435,8,17,.471,2,6,.333,6,10,.600,2,7,9,7,0,1,5,0,28,18.4
33-027,2018-01-26,CLE,H,IND,W,1,40,11,17,.647,11,15,.733,0,2,.000,4,5,.800,0,10,10,11,4,1,11,0,26,22.5
33-029,2018-01-28,CLE,H,DET,W,1,38,8,15,.533,7,11,.636,1,4,.250,8,9,.889,1,7,8,14,1,0,3,0,25,27.9
33-031,2018-01-30,CLE,A,DET,L,1,38,9,20,.450,7,13,.538,2,7,.286,1,2,.500,0,6,6,7,0,1,4,2,21,12.8
33-032,2018-01-31,CLE,H,MIA,W,1,38,8,21,.381,7,15,.467,1,6,.167,7,11,.636,2,9,11,5,1,0,7,1,24,12.1
33-035,2018-02-03,CLE,H,HOU,L,1,31,3,10,.300,2,8,.250,1,2,.500,4,4,1.000,1,8,9,9,2,1,2,0,11,15.3
33-038,2018-02-06,CLE,A,ORL,L,1,33,10,17,.588,8,13,.615,2,4,.500,3,4,.750,1,9,10,5,1,0,6,4,25,17.0
33-039,2018-02-07,CLE,H,MIN,W,1,48,16,22,.727,11,15,.733,5,7,.714,0,2,.000,1,9,10,15,1,1,5,3,37,36.6
33-041,2018-02-09,CLE,A,ATL,W,1,41,8,20,.400,8,17,.471,0,3,.000,6,7,.857,2,10,12,19,0,0,3,2,22,24.7
33-043,2018-02-11,CLE,A,BOS,W,1,28,9,20,.450,7,15,.467,2,5,.400,4,7,.571,0,8,8,10,1,1,2,1,24,21.1
33-045,2018-02-13,CLE,A,OKC,W,1,40,14,23,.609,11,16,.688,3,7,.429,6,10,.600,0,8,8,8,0,1,5,1,37,28.2
33-054,2018-02-22,CLE,H,WAS,L,1,37,13,18,.722,12,14,.857,1,4,.250,5,9,.556,1,8,9,8,2,0,4,2,32,28.9
33-055,2018-02-23,CLE,A,MEM,W,1,37,7,16,.438,7,14,.500,0,2,.000,4,4,1.000,0,14,14,11,1,0,3,0,18,19.5
33-057,2018-02-25,CLE,H,SAS,L,1,40,14,25,.560,12,20,.600,2,5,.400,3,4,.750,2,11,13,9,1,0,6,3,33,25.5
33-059,2018-02-27,CLE,H,BRK,W,1,39,13,25,.520,11,21,.524,2,4,.500,3,3,1.000,4,8,12,11,1,0,1,1,31,31.2
33-061,2018-03-01,CLE,H,PHI,L,1,39,12,24,.500,10,18,.556,2,6,.333,4,6,.667,1,8,9,8,1,0,3,2,30,23.1
33-063,2018-03-03,CLE,H,DEN,L,1,42,8,19,.421,7,15,.467,1,4,.250,8,11,.727,1,9,10,15,2,0,3,2,25,25.8
33-065,2018-03-05,CLE,H,DET,W,1,29,11,17,.647,6,10,.600,5,7,.714,4,6,.667,2,5,7,7,1,0,3,2,31,27.7
33-067,2018-03-07,CLE,A,DEN,W,1,39,15,25,.600,10,17,.588,5,8,.625,4,8,.500,1,7,8,10,1,0,3,2,39,32.9
33-069,2018-03-09,CLE,A,LAC,L,1,39,11,20,.550,8,13,.615,3,7,.429,0,2,.000,0,10,10,6,2,3,5,2,25,20.1
33-071,2018-03-11,CLE,A,LAL,L,1,31,9,20,.450,7,12,.583,2,8,.250,4,5,.800,2,8,10,7,1,1,2,0,24,21.6
33-073,2018-03-13,CLE,A,PHO,W,1,33,7,14,.500,6,12,.500,1,2,.500,13,15,.867,0,12,12,11,3,2,5,2,28,30.1
33-075,2018-03-15,CLE,A,POR,L,1,41,15,25,.600,14,21,.667,1,4,.250,4,9,.444,0,14,14,6,2,3,6,4,35,26.4
33-077,2018-03-17,CLE,A,CHI,W,1,40,15,26,.577,13,18,.722,2,8,.250,1,4,.250,1,12,13,12,1,2,6,3,33,27.5
33-079,2018-03-19,CLE,H,MIL,W,1,40,16,29,.552,13,22,.591,3,7,.429,5,8,.625,5,7,12,10,2,1,6,2,40,33.4
33-081,2018-03-21,CLE,H,TOR,W,1,39,11,19,.579,10,16,.625,1,3,.333,12,14,.857,1,6,7,17,1,0,0,2,35,39.9
33-083,2018-03-23,CLE,H,PHO,W,1,29,11,16,.688,10,12,.833,1,4,.250,4,6,.667,0,6,6,9,1,1,4,3,27,24.0
33-085,2018-03-25,CLE,A,BRK,W,1,38,14,19,.737,13,15,.867,1,4,.250,8,10,.800,2,8,10,8,1,0,2,3,37,35.7
33-087,2018-03-27,CLE,A,MIA,L,1,38,7,18,.389,7,14,.500,0,4,.000,4,5,.800,1,5,6,7,0,0,6,1,18,8.5
33-088,2018-03-28,CLE,A,CHO,W,1,37,14,26,.538,10,18,.556,4,8,.500,9,11,.818,2,8,10,8,1,0,4,1,41,33.6
33-090,2018-03-30,CLE,H,NOP,W,1,42,12,24,.500,12,20,.600,0,4,.000,3,3,1.000,1,8,9,11,1,0,1,0,27,25.8
33-092,2018-04-01,CLE,H,DAL,W,1,39,5,21,.238,3,18,.167,2,3,.667,4,4,1.000,3,10,13,12,0,0,2,1,16,14.4
33-094,2018-04-03,CLE,H,TOR,W,1,37,8,14,.571,5,8,.625,3,6,.500,8,11,.727,0,10,10,6,0,0,5,2,27,20.6
33-096,2018-04-05,CLE,H,WAS,W,1,39,12,20,.600,10,13,.769,2,7,.286,7,10,.700,2,7,9,14,0,0,6,2,33,29.1
33-097,2018-04-06,CLE,A,PHI,L,1,40,17,29,.586,13,21,.619,4,8,.500,6,11,.545,1,10,11,11,2,1,8,0,44,34.6
33-100,2018-04-09,CLE,A,NYK,W,1,39,7,16,.438,4,10,.400,3,6,.500,9,10,.900,0,6,6,11,1,0,4,2,26,22.9
33-102,2018-04-11,CLE,H,NYK,L,1,11,4,9,.444,4,7,.571,0,2,.000,2,3,.667,1,4,5,2,1,0,3,0,10,6.2
33-292,2018-10-18,LAL,A,POR,L,1,37,9,16,.563,9,12,.750,0,4,.000,8,9,.889,2,10,12,6,1,0,6,3,26,20.4
33-294,2018-10-20,LAL,H,HOU,L,1,39,9,22,.409,8,15,.533,1,7,.143,5,7,.714,0,5,5,5,2,1,1,0,24,18.1
33-296,2018-10-22,LAL,H,SAS,L,1,43,11,25,.440,9,17,.529,2,8,.250,8,11,.727,2,6,8,14,1,1,5,2,32,26.6
33-298,2018-10-24,LAL,A,PHO,W,1,28,7,16,.438,6,11,.545,1,5,.200,4,4,1.000,0,7,7,10,3,0,0,1,19,22.3
33-299,2018-10-25,LAL,H,DEN,W,1,35,10,17,.588,9,12,.750,1,5,.200,7,10,.700,0,11,11,11,3,0,2,3,28,29.7
33-301,2018-10-27,LAL,A,SAS,L,1,34,13,21,.619,11,15,.733,2,6,.333,7,8,.875,1,10,11,4,2,0,4,3,35,28.4
33-303,2018-10-29,LAL,A,MIN,L,1,36,11,23,.478,8,17,.471,3,6,.500,4,5,.800,3,7,10,8,2,2,5,2,29,24.3
33-305,2018-10-31,LAL,H,DAL,W,1,39,11,19,.579,9,16,.563,2,3,.667,5,7,.714,0,5,5,6,3,0,3,3,29,23.8
33-308,2018-11-03,LAL,A,POR,W,1,31,9,20,.450,8,15,.533,1,5,.200,9,11,.818,0,5,5,7,0,2,3,1,28,21.2
33-309,2018-11-04,LAL,H,TOR,L,1,28,6,12,.500,4,9,.444,2,3,.667,4,7,.571,0,2,2,6,0,1,3,3,18,12.1
33-312,2018-11-07,LAL,H,MIN,W,1,39,10,21,.476,7,12,.583,3,9,.333,1,2,.500,1,10,11,9,0,2,3,1,24,20.9
33-315,2018-11-10,LAL,A,SAC,W,1,31,10,18,.556,7,12,.583,3,6,.500,2,3,.667,1,6,7,2,1,0,3,2,25,17.1
33-316,2018-11-11,LAL,H,ATL,W,1,34,10,20,.500,7,11,.636,3,9,.333,3,7,.429,3,4,7,4,2,0,4,1,26,18.1
33-319,2018-11-14,LAL,H,POR,W,1,36,13,19,.684,8,13,.615,5,6,.833,13,15,.867,2,8,10,9,1,3,4,0,44,44.3
33-322,2018-11-17,LAL,A,ORL,L,1,26,8,19,.421,5,13,.385,3,6,.500,3,4,.750,0,4,4,7,0,1,3,0,22,15.3
33-323,2018-11-18,LAL,A,MIA,W,1,38,19,31,.613,13,23,.565,6,8,.750,7,10,.700,1,7,8,3,2,1,2,3,51,40.1
33-326,2018-11-21,LAL,A,CLE,W,1,36,11,20,.550,9,14,.643,2,6,.333,8,12,.667,2,12,14,7,0,1,4,3,32,26.2
33-328,2018-11-23,LAL,H,UTA,W,1,35,8,17,.471,6,12,.500,2,5,.400,4,6,.667,1,9,10,7,2,1,5,1,22,18.1
33-330,2018-11-25,LAL,H,ORL,L,1,40,8,14,.571,6,7,.857,2,7,.286,6,11,.545,0,4,4,7,0,1,6,4,24,14.6
33-332,2018-11-27,LAL,A,DEN,L,1,30,5,15,.333,5,11,.455,0,4,.000,4,6,.667,0,7,7,2,2,2,4,0,14,7.6
33-334,2018-11-29,LAL,H,IND,W,1,38,15,27,.556,13,20,.650,2,7,.286,6,10,.600,1,8,9,7,2,0,4,2,38,28.7
33-335,2018-11-30,LAL,H,DAL,W,1,31,12,21,.571,10,17,.588,2,4,.500,2,4,.500,2,3,5,4,0,1,4,3,28,17.9
33-337,2018-12-02,LAL,H,PHO,W,1,31,9,17,.529,8,12,.667,1,5,.200,3,4,.750,0,6,6,8,0,1,5,0,22,16.4
33-340,2018-12-05,LAL,H,SAS,W,1,40,15,24,.625,12,17,.706,3,7,.429,9,13,.692,0,5,5,6,2,0,2,1,42,34.9
33-342,2018-12-07,LAL,A,SAS,L,1,37,13,28,.464,10,20,.500,3,8,.375,6,9,.667,2,6,8,11,2,0,1,4,35,29.7
33-343,2018-12-08,LAL,A,MEM,W,1,32,9,18,.500,9,15,.600,0,3,.000,2,3,.667,1,7,8,9,2,0,5,2,20,15.9
33-345,2018-12-10,LAL,H,MIA,W,1,38,10,19,.526,6,12,.500,4,7,.571,4,8,.500,0,9,9,12,1,0,2,0,28,27.2
33-348,2018-12-13,LAL,A,HOU,L,1,36,12,18,.667,9,12,.750,3,6,.500,2,6,.333,0,5,5,4,2,0,3,1,29,22.5
33-350,2018-12-15,LAL,A,CHO,W,1,30,7,15,.467,5,9,.556,2,6,.333,8,12,.667,1,11,12,11,1,0,3,0,24,24.4
33-351,2018-12-16,LAL,A,WAS,L,1,32,5,16,.313,5,14,.357,0,2,.000,3,6,.500,0,6,6,3,0,1,4,0,13,3.2
33-353,2018-12-18,LAL,A,BRK,L,1,41,13,23,.565,11,16,.688,2,7,.286,8,13,.615,1,12,13,8,1,1,5,1,36,29.3
33-356,2018-12-21,LAL,H,NOP,W,1,39,8,20,.400,8,16,.500,0,4,.000,6,9,.667,2,10,12,14,2,0,2,3,22,23.0
33-358,2018-12-23,LAL,H,MEM,L,1,36,8,14,.571,6,9,.667,2,5,.400,4,4,1.000,1,13,14,7,1,1,4,0,22,22.6
33-360,2018-12-25,LAL,A,GSW,W,1,21,6,11,.545,6,9,.667,0,2,.000,5,8,.625,2,11,13,5,1,0,2,1,17,17.3
34-032,2019-01-31,LAL,A,LAC,W,1,40,9,22,.409,8,16,.500,1,6,.167,5,7,.714,1,13,14,9,1,0,4,0,24,19.3
34-037,2019-02-05,LAL,A,IND,L,1,30,7,12,.583,5,7,.714,2,5,.400,2,3,.667,0,7,7,9,1,0,6,1,18,15.0
34-039,2019-02-07,LAL,A,BOS,W,1,38,11,21,.524,6,11,.545,5,10,.500,1,5,.200,2,10,12,12,3,0,3,4,28,27.3
34-042,2019-02-10,LAL,A,PHI,L,1,33,8,16,.500,6,10,.600,2,6,.333,0,0,,0,10,10,9,0,0,4,3,18,14.1
34-044,2019-02-12,LAL,A,ATL,L,1,43,8,20,.400,5,10,.500,3,10,.300,9,11,.818,2,9,11,16,3,1,2,3,28,32.2
34-053,2019-02-21,LAL,H,HOU,W,1,40,11,23,.478,11,19,.579,0,4,.000,7,10,.700,4,8,12,6,1,1,4,1,29,22.8
34-055,2019-02-23,LAL,A,NOP,L,1,39,11,17,.647,8,11,.727,3,6,.500,2,6,.333,0,7,7,12,4,1,4,0,27,29.1
34-057,2019-02-25,LAL,A,MEM,L,1,40,8,23,.348,8,19,.421,0,4,.000,8,10,.800,3,9,12,11,3,0,5,3,24,19.6
34-059,2019-02-27,LAL,H,NOP,W,1,37,13,24,.542,9,15,.600,4,9,.444,3,8,.375,1,5,6,10,2,1,2,2,33,28.5
34-061,2019-03-01,LAL,H,MIL,L,1,39,10,19,.526,7,11,.636,3,8,.375,8,10,.800,2,5,7,10,1,0,3,2,31,28.0
34-062,2019-03-02,LAL,A,PHO,L,1,41,10,21,.476,6,12,.500,4,9,.444,3,7,.429,0,9,9,16,0,0,3,2,27,24.8
34-064,2019-03-04,LAL,H,LAC,L,1,42,9,18,.500,8,12,.667,1,6,.167,8,12,.667,0,8,8,6,1,1,2,3,27,21.5
34-066,2019-03-06,LAL,H,DEN,L,1,31,13,22,.591,11,15,.733,2,7,.286,3,8,.375,0,7,7,7,1,1,4,4,31,21.9
34-069,2019-03-09,LAL,H,BOS,L,1,28,13,23,.565,12,18,.667,1,5,.200,3,7,.429,2,8,10,12,0,0,3,0,30,26.7
34-072,2019-03-12,LAL,A,CHI,W,1,33,15,23,.652,13,19,.684,2,4,.500,4,5,.800,1,9,10,4,2,0,5,2,36,27.9
34-074,2019-03-14,LAL,A,TOR,L,1,32,12,23,.522,11,18,.611,1,5,.200,4,7,.571,0,4,4,6,1,0,4,2,29,18.1
34-077,2019-03-17,LAL,A,NYK,L,1,35,11,26,.423,11,20,.550,0,6,.000,11,13,.846,2,4,6,8,0,1,2,2,33,24.5
34-082,2019-03-22,LAL,H,BRK,L,1,37,8,25,.320,7,18,.389,1,7,.143,8,12,.667,3,6,9,14,1,1,8,3,25,15.3
34-084,2019-03-24,LAL,H,SAC,W,1,35,9,22,.409,6,16,.375,3,6,.500,8,9,.889,2,9,11,11,2,1,4,1,29,26.9
34-086,2019-03-26,LAL,H,WAS,W,1,34,11,20,.550,10,14,.714,1,6,.167,0,2,.000,0,7,7,14,1,0,3,1,23,22.1
34-089,2019-03-29,LAL,H,CHO,W,1,32,11,19,.579,7,12,.583,4,7,.571,1,2,.500,0,3,3,9,0,0,6,1,27,18.5
34-301,2019-10-27,LAL,H,CHO,W,1,35,7,14,.500,6,11,.545,1,3,.333,5,5,1.000,1,5,6,12,1,0,4,0,20,20.6
34-303,2019-10-29,LAL,H,MEM,W,1,28,8,15,.533,6,10,.600,2,5,.400,5,7,.714,0,2,2,8,0,1,6,0,23,15.8
34-306,2019-11-01,LAL,A,DAL,W,1,43,13,23,.565,9,14,.643,4,9,.444,9,11,.818,0,12,12,16,4,1,4,5,39,40.8
34-308,2019-11-03,LAL,A,SAS,W,1,37,8,23,.348,8,17,.471,0,6,.000,5,10,.500,1,10,11,13,2,1,5,2,21,15.8
34-310,2019-11-05,LAL,A,CHI,W,1,35,10,19,.526,8,13,.615,2,6,.333,8,9,.889,0,10,10,11,2,1,2,3,30,30.5
34-313,2019-11-08,LAL,H,MIA,W,1,36,10,19,.526,6,12,.500,4,7,.571,1,2,.500,1,3,4,6,0,0,3,2,25,17.3
34-315,2019-11-10,LAL,H,TOR,L,1,35,5,15,.333,5,13,.385,0,2,.000,3,6,.500,3,10,13,15,0,1,2,0,13,17.6
34-317,2019-11-12,LAL,A,PHO,W,1,37,8,18,.444,7,14,.500,1,4,.250,2,7,.286,0,7,7,11,0,0,1,0,19,16.4
34-318,2019-11-13,LAL,H,GSW,W,1,26,11,21,.524,10,16,.625,1,5,.200,0,1,.000,2,4,6,12,1,1,4,1,23,20.6
34-320,2019-11-15,LAL,H,SAC,W,1,39,10,20,.500,8,13,.615,2,7,.286,7,7,1.000,3,1,4,11,3,0,2,1,29,29.7
34-322,2019-11-17,LAL,H,ATL,W,1,33,13,21,.619,7,11,.636,6,10,.600,1,1,1.000,0,7,7,12,1,1,0,1,33,35.3
34-324,2019-11-19,LAL,H,OKC,W,1,37,10,21,.476,8,16,.500,2,5,.400,3,5,.600,0,11,11,10,2,0,7,2,25,18.0
34-327,2019-11-22,LAL,A,OKC,W,1,36,9,20,.450,8,17,.471,1,3,.333,4,6,.667,1,5,6,14,1,1,5,2,23,19.7
34-328,2019-11-23,LAL,A,MEM,W,1,39,14,27,.519,12,18,.667,2,9,.222,0,0,,1,5,6,4,2,0,5,1,30,18.3
34-330,2019-11-25,LAL,A,SAS,W,1,35,13,24,.542,9,17,.529,4,7,.571,3,8,.375,1,3,4,14,0,1,3,2,33,27.7
34-332,2019-11-27,LAL,A,NOP,W,1,38,10,18,.556,8,12,.667,2,6,.333,7,11,.636,2,3,5,11,2,1,5,2,29,25.7
34-334,2019-11-29,LAL,H,WAS,W,1,25,9,16,.563,5,8,.625,4,8,.500,1,2,.500,0,3,3,11,2,1,6,1,23,19.9
34-336,2019-12-01,LAL,H,DAL,L,1,36,11,20,.550,11,15,.733,0,5,.000,3,3,1.000,0,9,9,8,4,0,6,3,25,20.5
34-338,2019-12-03,LAL,A,DEN,W,1,37,9,18,.500,8,14,.571,1,4,.250,6,6,1.000,2,4,6,9,0,0,4,3,25,19.7
34-339,2019-12-04,LAL,A,UTA,W,1,29,9,21,.429,8,15,.533,1,6,.167,1,1,1.000,0,4,4,12,1,0,1,3,20,17.3
34-341,2019-12-06,LAL,A,POR,W,1,34,11,23,.478,7,14,.500,4,9,.444,5,7,.714,1,6,7,8,0,1,3,1,31,23.9
34-343,2019-12-08,LAL,H,MIN,W,1,28,12,20,.600,6,12,.500,6,8,.750,2,2,1.000,1,3,4,13,1,0,5,4,32,27.9
34-346,2019-12-11,LAL,A,ORL,W,1,38,11,24,.458,10,18,.556,1,6,.167,2,5,.400,2,9,11,10,2,0,6,2,25,17.7
34-348,2019-12-13,LAL,A,MIA,W,1,37,11,22,.500,7,14,.500,4,8,.500,2,4,.500,2,7,9,12,1,0,8,2,28,20.3
34-350,2019-12-15,LAL,A,ATL,W,1,37,12,21,.571,8,11,.727,4,10,.400,4,7,.571,1,12,13,7,1,3,4,1,32,28.8
34-352,2019-12-17,LAL,A,IND,L,1,35,8,20,.400,8,14,.571,0,6,.000,4,8,.500,1,8,9,9,0,0,5,2,20,11.2
34-354,2019-12-19,LAL,A,MIL,L,1,37,8,19,.421,5,12,.417,3,7,.429,2,2,1.000,0,12,12,11,0,0,4,5,21,16.2
34-360,2019-12-25,LAL,H,LAC,L,1,39,9,24,.375,7,12,.583,2,12,.167,3,4,.750,3,6,9,10,2,1,2,3,23,19.8
34-363,2019-12-28,LAL,A,POR,W,1,37,7,15,.467,6,11,.545,1,4,.250,6,8,.750,1,6,7,16,2,1,1,2,21,27.1
34-364,2019-12-29,LAL,H,DAL,W,1,34,3,10,.300,1,6,.167,2,4,.500,5,6,.833,0,6,6,13,2,0,2,2,13,16.9
35-002,2020-01-01,LAL,H,PHO,W,1,38,11,21,.524,10,17,.588,1,4,.250,8,12,.667,2,11,13,12,2,1,5,0,31,29.9
35-004,2020-01-03,LAL,H,NOP,W,1,37,7,17,.412,6,14,.429,1,3,.333,2,5,.400,0,8,8,15,2,0,2,1,17,19.2
35-006,2020-01-05,LAL,H,DET,W,1,35,10,21,.476,10,18,.556,0,3,.000,1,2,.500,3,11,14,11,0,0,3,2,21,19.2
35-008,2020-01-07,LAL,H,NYK,W,1,31,9,19,.474,3,7,.429,6,12,.500,7,7,1.000,0,5,5,5,2,1,4,2,31,24.2
35-011,2020-01-10,LAL,A,DAL,W,1,32,14,25,.560,11,19,.579,3,6,.500,4,5,.800,2,14,16,7,1,0,3,0,35,31.2
35-014,2020-01-13,LAL,H,CLE,W,1,33,12,16,.750,11,13,.846,1,3,.333,6,7,.857,0,2,2,8,1,0,3,2,31,27.6
35-016,2020-01-15,LAL,H,ORL,L,1,36,7,19,.368,5,10,.500,2,9,.222,3,5,.600,0,3,3,19,1,0,5,1,19,17.5
35-019,2020-01-18,LAL,A,HOU,W,1,35,13,25,.520,11,18,.611,2,7,.286,3,5,.600,0,5,5,12,2,0,6,3,31,22.6
35-021,2020-01-20,LAL,A,BOS,L,1,29,5,12,.417,5,10,.500,0,2,.000,5,5,1.000,3,4,7,13,0,0,4,1,15,16.6
35-023,2020-01-22,LAL,A,NYK,W,1,36,9,16,.563,7,11,.636,2,5,.400,1,3,.333,0,6,6,5,5,0,4,0,21,18.9
35-024,2020-01-23,LAL,A,BRK,W,1,34,11,19,.579,8,13,.615,3,6,.500,2,2,1.000,2,9,11,10,1,1,5,0,27,25.9
